"typeResult","idGame","slugTeam","idTeam","fgm","fga","pctFG","fg3m","fg3a","pctFG3","pctFT","fg2m","fg2a","pctFG2","teamName","cityTeam","minExact","ftm","fta","oreb","dreb","treb","ast","stl","blk","tov","pf","pts","plusminus"
"team",21900001,"TOR",1610612761,42,103,0.408,14,40,0.35,0.842,28,63,0.444444444444444,"Raptors","Toronto",265,32,38,16,41,57,23,7,3,16,24,130,8
"team",21900001,"NOP",1610612740,43,102,0.422,19,45,0.422222222222222,0.85,24,57,0.421052631578947,"Pelicans","New Orleans",265,17,20,16,37,53,30,4,9,19,34,122,-8
"team",21900002,"LAL",1610612747,37,85,0.435,13,33,0.393939393939394,0.714,24,52,0.461538461538462,"Lakers","Los Angeles",240,15,21,9,32,41,20,4,7,14,24,102,-10
"team",21900002,"LAC",1610612746,42,81,0.519,11,31,0.354838709677419,0.708,31,50,0.62,"Clippers","LA",240,17,24,11,34,45,24,8,5,14,25,112,10
"team",21900003,"CHI",1610612741,49,105,0.467,9,30,0.3,0.818,40,75,0.533333333333333,"Bulls","Chicago",240,18,22,20,29,49,25,11,4,10,20,125,-1
"team",21900003,"CHA",1610612766,45,88,0.511,23,44,0.522727272727273,0.813,22,44,0.5,"Hornets","Charlotte",240,13,16,9,32,41,28,3,4,19,18,126,1
"team",21900004,"IND",1610612754,41,89,0.461,8,21,0.380952380952381,0.833,33,68,0.485294117647059,"Pacers","Indiana",240,20,24,10,26,36,26,8,6,15,28,110,-9
"team",21900004,"DET",1610612765,41,78,0.526,11,24,0.458333333333333,0.788,30,54,0.555555555555556,"Pistons","Detroit",240,26,33,10,35,45,26,5,6,18,21,119,9
"team",21900005,"ORL",1610612753,37,86,0.43,9,30,0.3,0.579,28,56,0.5,"Magic","Orlando",240,11,19,7,39,46,24,12,4,13,18,94,9
"team",21900005,"CLE",1610612739,33,88,0.375,9,34,0.264705882352941,0.667,24,54,0.444444444444444,"Cavaliers","Cleveland",240,10,15,10,44,54,20,8,2,16,15,85,-9
"team",21900006,"MIN",1610612750,46,108,0.426,13,43,0.302325581395349,0.786,33,65,0.507692307692308,"Timberwolves","Minnesota",265,22,28,12,40,52,23,9,4,13,22,127,1
"team",21900006,"BKN",1610612751,48,101,0.475,15,34,0.441176470588235,0.577,33,67,0.492537313432836,"Nets","Brooklyn",265,15,26,10,38,48,19,8,9,16,30,126,-1
"team",21900007,"MIA",1610612748,40,85,0.471,7,18,0.388888888888889,0.846,33,67,0.492537313432836,"Heat","Miami",240,33,39,11,40,51,18,9,8,21,33,120,19
"team",21900007,"MEM",1610612763,38,89,0.427,5,32,0.15625,0.667,33,57,0.578947368421053,"Grizzlies","Memphis",240,20,30,9,31,40,22,9,7,24,31,101,-19
"team",21900008,"PHI",1610612755,37,85,0.435,7,29,0.241379310344828,0.722,30,56,0.535714285714286,"76ers","Philadelphia",240,26,36,12,50,62,24,6,7,15,34,107,14
"team",21900008,"BOS",1610612738,33,90,0.367,7,26,0.269230769230769,0.588,26,64,0.40625,"Celtics","Boston",240,20,34,10,31,41,18,4,2,10,29,93,-14
"team",21900009,"WAS",1610612764,37,93,0.398,11,41,0.268292682926829,0.833,26,52,0.5,"Wizards","Washington",240,15,18,11,36,47,26,6,3,17,32,100,-8
"team",21900009,"DAL",1610612742,35,76,0.461,11,36,0.305555555555556,0.818,24,40,0.6,"Mavericks","Dallas",240,27,33,5,41,46,17,6,5,19,22,108,8
"team",21900010,"SAS",1610612759,42,83,0.506,7,21,0.333333333333333,0.806,35,62,0.564516129032258,"Spurs","San Antonio",240,29,36,10,41,51,22,6,5,21,18,120,9
"team",21900010,"NYK",1610612752,44,94,0.468,10,30,0.333333333333333,0.722,34,64,0.53125,"Knicks","New York",240,13,18,5,34,39,24,16,1,14,32,111,-9
"team",21900011,"UTA",1610612762,40,90,0.444,6,24,0.25,0.7,34,66,0.515151515151515,"Jazz","Utah",240,14,20,11,38,49,15,4,5,11,31,100,5
"team",21900011,"OKC",1610612760,32,83,0.386,10,27,0.37037037037037,0.677,22,56,0.392857142857143,"Thunder","Oklahoma City",240,21,31,7,41,48,15,5,4,13,23,95,-5
"team",21900012,"SAC",1610612758,34,87,0.391,10,29,0.344827586206897,0.654,24,58,0.413793103448276,"Kings","Sacramento",240,17,26,12,35,47,17,5,5,26,24,95,-29
"team",21900012,"PHX",1610612756,49,98,0.5,11,33,0.333333333333333,0.833,38,65,0.584615384615385,"Suns","Phoenix",240,15,18,9,35,44,31,13,9,14,25,124,29
"team",21900013,"POR",1610612757,36,87,0.414,7,28,0.25,0.913,29,59,0.491525423728814,"Trail Blazers","Portland",240,21,23,13,35,48,13,9,4,20,25,100,-8
"team",21900013,"DEN",1610612743,34,81,0.42,18,32,0.5625,0.815,16,49,0.326530612244898,"Nuggets","Denver",240,22,27,11,34,45,24,11,4,19,23,108,8
"team",21900014,"DET",1610612765,35,85,0.412,10,37,0.27027027027027,0.909,25,48,0.520833333333333,"Pistons","Detroit",240,20,22,9,30,39,20,6,5,13,20,100,-17
"team",21900014,"ATL",1610612737,44,86,0.512,11,31,0.354838709677419,0.857,33,55,0.6,"Hawks","Atlanta",240,18,21,8,34,42,27,9,2,13,15,117,17
"team",21900015,"MIL",1610612749,46,99,0.465,16,46,0.347826086956522,0.5,30,53,0.566037735849057,"Bucks","Milwaukee",240,9,18,6,47,53,31,7,10,11,27,117,6
"team",21900015,"HOU",1610612745,33,90,0.367,16,48,0.333333333333333,0.744,17,42,0.404761904761905,"Rockets","Houston",240,29,39,10,47,57,25,6,6,14,25,111,-6
"team",21900016,"LAC",1610612746,50,80,0.625,18,32,0.5625,0.767,32,48,0.666666666666667,"Clippers","LA",240,23,30,3,36,39,33,7,5,17,24,141,19
"team",21900016,"GSW",1610612744,39,99,0.394,15,42,0.357142857142857,0.967,24,57,0.421052631578947,"Warriors","Golden State",240,29,30,15,27,42,27,7,0,13,21,122,-19
"team",21900017,"TOR",1610612761,37,78,0.474,18,36,0.5,0.824,19,42,0.452380952380952,"Raptors","Toronto",240,14,17,5,41,46,22,2,6,23,28,106,-6
"team",21900017,"BOS",1610612738,42,109,0.385,13,38,0.342105263157895,0.938,29,71,0.408450704225352,"Celtics","Boston",240,15,16,21,35,56,21,10,8,9,20,112,6
"team",21900018,"MIN",1610612750,43,91,0.473,12,38,0.315789473684211,0.742,31,53,0.584905660377358,"Timberwolves","Minnesota",240,23,31,13,39,52,30,11,6,15,21,121,22
"team",21900018,"CHA",1610612766,37,84,0.44,12,29,0.413793103448276,0.5,25,55,0.454545454545455,"Hornets","Charlotte",240,13,26,9,33,42,26,6,5,19,29,99,-22
"team",21900019,"NYK",1610612752,38,81,0.469,17,25,0.68,0.571,21,56,0.375,"Knicks","New York",240,16,28,9,30,39,17,14,4,26,31,109,-4
"team",21900019,"BKN",1610612751,37,78,0.474,16,37,0.432432432432432,0.676,21,41,0.51219512195122,"Nets","Brooklyn",240,23,34,11,35,46,21,11,2,26,26,113,4
"team",21900020,"MEM",1610612763,39,94,0.415,10,29,0.344827586206897,0.7,29,65,0.446153846153846,"Grizzlies","Memphis",240,14,20,15,41,56,24,8,6,18,21,102,-8
"team",21900020,"CHI",1610612741,40,93,0.43,12,42,0.285714285714286,0.75,28,51,0.549019607843137,"Bulls","Chicago",240,18,24,9,36,45,18,14,7,13,21,110,8
"team",21900021,"NOP",1610612740,45,98,0.459,15,41,0.365853658536585,0.733,30,57,0.526315789473684,"Pelicans","New Orleans",240,11,15,12,36,48,30,6,3,14,22,116,-7
"team",21900021,"DAL",1610612742,45,93,0.484,14,40,0.35,0.731,31,53,0.584905660377358,"Mavericks","Dallas",240,19,26,12,37,49,23,8,7,11,19,123,7
"team",21900022,"WAS",1610612764,39,97,0.402,11,41,0.268292682926829,0.8,28,56,0.5,"Wizards","Washington",240,8,10,8,39,47,21,9,6,15,21,97,12
"team",21900022,"OKC",1610612760,33,83,0.398,5,23,0.217391304347826,0.636,28,60,0.466666666666667,"Thunder","Oklahoma City",240,14,22,7,42,49,14,7,6,18,18,85,-12
"team",21900023,"PHX",1610612756,34,86,0.395,8,28,0.285714285714286,0.969,26,58,0.448275862068966,"Suns","Phoenix",265,31,32,10,44,54,25,5,1,17,35,107,-1
"team",21900023,"DEN",1610612743,36,92,0.391,7,27,0.259259259259259,0.806,29,65,0.446153846153846,"Nuggets","Denver",265,29,36,8,37,45,21,7,12,14,26,108,1
"team",21900024,"SAC",1610612758,37,87,0.425,15,37,0.405405405405405,0.852,22,50,0.44,"Kings","Sacramento",240,23,27,13,30,43,17,10,2,17,26,112,-10
"team",21900024,"POR",1610612757,46,85,0.541,11,30,0.366666666666667,0.864,35,55,0.636363636363636,"Trail Blazers","Portland",240,19,22,5,35,40,23,8,5,16,23,122,10
"team",21900025,"UTA",1610612762,29,70,0.414,8,25,0.32,0.952,21,45,0.466666666666667,"Jazz","Utah",240,20,21,3,37,40,19,8,2,22,25,86,-9
"team",21900025,"LAL",1610612747,34,86,0.395,8,26,0.307692307692308,0.792,26,60,0.433333333333333,"Lakers","Los Angeles",240,19,24,11,31,42,19,14,9,14,21,95,9
"team",21900026,"MIL",1610612749,41,94,0.436,17,54,0.314814814814815,0.771,24,40,0.6,"Bucks","Milwaukee",265,27,35,5,42,47,22,8,4,18,32,126,-5
"team",21900026,"MIA",1610612748,46,101,0.455,16,44,0.363636363636364,0.639,30,57,0.526315789473684,"Heat","Miami",265,23,36,8,46,54,33,7,3,16,30,131,5
"team",21900027,"PHI",1610612755,42,87,0.483,13,34,0.382352941176471,0.667,29,53,0.547169811320755,"76ers","Philadelphia",240,20,30,6,32,38,30,14,3,22,26,117,6
"team",21900027,"DET",1610612765,41,76,0.539,8,19,0.421052631578947,0.583,33,57,0.578947368421053,"Pistons","Detroit",240,21,36,5,30,35,20,11,7,23,28,111,-6
"team",21900028,"ORL",1610612753,35,99,0.354,5,31,0.161290322580645,0.923,30,68,0.441176470588235,"Magic","Orlando",240,24,26,17,29,46,15,8,7,10,15,99,-4
"team",21900028,"ATL",1610612737,43,84,0.512,9,30,0.3,0.533,34,54,0.62962962962963,"Hawks","Atlanta",240,8,15,9,43,52,22,5,9,18,26,103,4
"team",21900029,"NYK",1610612752,31,82,0.378,7,27,0.259259259259259,0.765,24,55,0.436363636363636,"Knicks","New York",240,26,34,16,39,55,15,7,4,23,26,95,-23
"team",21900029,"BOS",1610612738,42,93,0.452,15,41,0.365853658536585,0.655,27,52,0.519230769230769,"Celtics","Boston",240,19,29,13,33,46,24,14,9,12,26,118,23
"team",21900030,"IND",1610612754,39,87,0.448,10,28,0.357142857142857,0.846,29,59,0.491525423728814,"Pacers","Indiana",240,11,13,6,30,36,23,7,3,17,25,99,-11
"team",21900030,"CLE",1610612739,40,80,0.5,11,31,0.354838709677419,0.655,29,49,0.591836734693878,"Cavaliers","Cleveland",240,19,29,12,32,44,23,9,7,18,20,110,11
"team",21900031,"TOR",1610612761,38,82,0.463,15,42,0.357142857142857,0.944,23,40,0.575,"Raptors","Toronto",240,17,18,10,49,59,27,9,12,22,25,108,24
"team",21900031,"CHI",1610612741,29,97,0.299,9,35,0.257142857142857,0.68,20,62,0.32258064516129,"Bulls","Chicago",240,17,25,12,33,45,18,9,2,15,22,84,-24
"team",21900032,"NOP",1610612740,46,100,0.46,18,50,0.36,0.813,28,50,0.56,"Pelicans","New Orleans",240,13,16,9,33,42,27,9,2,17,30,123,-3
"team",21900032,"HOU",1610612745,43,94,0.457,13,45,0.288888888888889,0.9,30,49,0.612244897959184,"Rockets","Houston",240,27,30,9,36,45,27,7,4,19,22,126,3
"team",21900033,"WAS",1610612764,47,95,0.495,16,34,0.470588235294118,0.706,31,61,0.508196721311475,"Wizards","Washington",240,12,17,8,33,41,30,3,8,12,15,122,-2
"team",21900033,"SAS",1610612759,50,108,0.463,10,28,0.357142857142857,0.824,40,80,0.5,"Spurs","San Antonio",240,14,17,21,32,53,29,6,7,9,19,124,2
"team",21900034,"UTA",1610612762,44,78,0.564,18,37,0.486486486486487,0.583,26,41,0.634146341463415,"Jazz","Utah",240,7,12,2,41,43,28,6,1,21,22,113,32
"team",21900034,"SAC",1610612758,30,81,0.37,7,26,0.269230769230769,0.824,23,55,0.418181818181818,"Kings","Sacramento",240,14,17,6,25,31,16,5,3,17,19,81,-32
"team",21900035,"PHX",1610612756,43,86,0.5,17,43,0.395348837209302,0.794,26,43,0.604651162790698,"Suns","Phoenix",240,27,34,9,40,49,32,9,3,16,34,130,8
"team",21900035,"LAC",1610612746,40,87,0.46,11,32,0.34375,0.795,29,55,0.527272727272727,"Clippers","LA",240,31,39,10,31,41,20,8,4,12,32,122,-8
"team",21900036,"OKC",1610612760,44,78,0.564,15,32,0.46875,0.773,29,46,0.630434782608696,"Thunder","Oklahoma City",240,17,22,8,42,50,24,8,5,23,26,120,28
"team",21900036,"GSW",1610612744,30,92,0.326,5,33,0.151515151515152,0.871,25,59,0.423728813559322,"Warriors","Golden State",240,27,31,12,27,39,17,13,2,14,15,92,-28
"team",21900037,"MEM",1610612763,50,103,0.485,14,33,0.424242424242424,0.8,36,70,0.514285714285714,"Grizzlies","Memphis",265,20,25,8,41,49,33,9,10,12,29,134,1
"team",21900037,"BKN",1610612751,44,101,0.436,15,45,0.333333333333333,0.811,29,56,0.517857142857143,"Nets","Brooklyn",265,30,37,11,42,53,28,6,5,17,22,133,-1
"team",21900038,"POR",1610612757,45,87,0.517,9,22,0.409090909090909,0.846,36,65,0.553846153846154,"Trail Blazers","Portland",240,22,26,7,41,48,13,6,4,16,30,121,2
"team",21900038,"DAL",1610612742,37,94,0.394,13,50,0.26,0.78,24,44,0.545454545454545,"Mavericks","Dallas",240,32,41,12,34,46,27,7,3,11,22,119,-2
"team",21900039,"MIN",1610612750,39,91,0.429,13,45,0.288888888888889,0.758,26,46,0.565217391304348,"Timberwolves","Minnesota",240,25,33,14,32,46,24,12,1,16,17,116,7
"team",21900039,"MIA",1610612748,42,85,0.494,15,36,0.416666666666667,0.667,27,49,0.551020408163265,"Heat","Miami",240,10,15,7,34,41,25,7,9,21,23,109,-7
"team",21900040,"LAL",1610612747,49,93,0.527,11,31,0.354838709677419,0.786,38,62,0.612903225806452,"Lakers","Los Angeles",240,11,14,10,37,47,30,7,8,13,22,120,19
"team",21900040,"CHA",1610612766,35,91,0.385,10,35,0.285714285714286,0.913,25,56,0.446428571428571,"Hornets","Charlotte",240,21,23,13,32,45,19,7,4,14,20,101,-19
"team",21900041,"IND",1610612754,39,94,0.415,6,21,0.285714285714286,0.769,33,73,0.452054794520548,"Pacers","Indiana",240,10,13,13,32,45,24,11,4,7,18,94,-2
"team",21900041,"DET",1610612765,37,81,0.457,13,24,0.541666666666667,0.9,24,57,0.421052631578947,"Pistons","Detroit",240,9,10,9,39,48,21,2,3,20,18,96,2
"team",21900042,"NYK",1610612752,38,91,0.418,9,29,0.310344827586207,0.625,29,62,0.467741935483871,"Knicks","New York",240,20,32,25,38,63,19,3,6,17,19,105,7
"team",21900042,"CHI",1610612741,36,85,0.424,9,35,0.257142857142857,0.81,27,50,0.54,"Bulls","Chicago",240,17,21,8,30,38,19,6,5,9,22,98,-7
"team",21900043,"PHI",1610612755,37,88,0.42,11,41,0.268292682926829,0.8,26,47,0.553191489361702,"76ers","Philadelphia",240,20,25,12,37,49,22,12,11,21,29,105,2
"team",21900043,"ATL",1610612737,36,84,0.429,9,27,0.333333333333333,0.688,27,57,0.473684210526316,"Hawks","Atlanta",240,22,32,8,37,45,23,12,3,21,25,103,-2
"team",21900044,"TOR",1610612761,33,85,0.388,10,39,0.256410256410256,0.933,23,46,0.5,"Raptors","Toronto",240,28,30,6,46,52,19,9,2,16,20,104,9
"team",21900044,"ORL",1610612753,34,89,0.382,12,39,0.307692307692308,0.833,22,50,0.44,"Magic","Orlando",240,15,18,8,39,47,22,9,6,16,20,95,-9
"team",21900045,"OKC",1610612760,41,94,0.436,13,35,0.371428571428571,0.708,28,59,0.474576271186441,"Thunder","Oklahoma City",240,17,24,16,36,52,22,7,3,13,27,112,-4
"team",21900045,"HOU",1610612745,39,90,0.433,10,44,0.227272727272727,0.848,29,46,0.630434782608696,"Rockets","Houston",240,28,33,9,31,40,21,6,6,14,24,116,4
"team",21900046,"MIL",1610612749,48,92,0.522,17,38,0.447368421052632,0.667,31,54,0.574074074074074,"Bucks","Milwaukee",240,16,24,8,42,50,29,9,7,12,15,129,17
"team",21900046,"CLE",1610612739,45,100,0.45,12,39,0.307692307692308,0.833,33,61,0.540983606557377,"Cavaliers","Cleveland",240,10,12,10,38,48,19,2,3,11,22,112,-17
"team",21900047,"NOP",1610612740,48,103,0.466,15,47,0.319148936170213,0.545,33,56,0.589285714285714,"Pelicans","New Orleans",240,12,22,11,30,41,36,13,7,15,20,123,-11
"team",21900047,"GSW",1610612744,51,104,0.49,14,35,0.4,0.75,37,69,0.536231884057971,"Warriors","Golden State",240,18,24,19,42,61,37,8,2,18,22,134,11
"team",21900048,"SAS",1610612759,41,85,0.482,7,22,0.318181818181818,0.75,34,63,0.53968253968254,"Spurs","San Antonio",240,24,32,7,43,50,25,5,9,18,19,113,3
"team",21900048,"POR",1610612757,39,100,0.39,10,33,0.303030303030303,0.815,29,67,0.432835820895522,"Trail Blazers","Portland",240,22,27,9,40,49,19,4,8,10,27,110,-3
"team",21900049,"UTA",1610612762,27,71,0.38,10,31,0.32258064516129,0.821,17,40,0.425,"Jazz","Utah",240,32,39,6,43,49,19,8,5,23,26,96,1
"team",21900049,"PHX",1610612756,33,80,0.412,13,34,0.382352941176471,0.696,20,46,0.434782608695652,"Suns","Phoenix",240,16,23,3,37,40,23,7,3,16,31,95,-1
"team",21900050,"SAC",1610612758,36,91,0.396,12,37,0.324324324324324,0.625,24,54,0.444444444444444,"Kings","Sacramento",240,10,16,15,33,48,25,6,8,12,21,94,-7
"team",21900050,"DEN",1610612743,36,98,0.367,10,36,0.277777777777778,0.905,26,62,0.419354838709677,"Nuggets","Denver",240,19,21,19,35,54,19,8,5,10,18,101,7
"team",21900051,"LAC",1610612746,40,83,0.482,12,33,0.363636363636364,0.905,28,50,0.56,"Clippers","LA",240,19,21,9,35,44,23,11,8,21,24,111,15
"team",21900051,"CHA",1610612766,36,83,0.434,14,39,0.358974358974359,0.714,22,44,0.5,"Hornets","Charlotte",240,10,14,9,29,38,24,5,3,21,23,96,-15
"team",21900052,"MIA",1610612748,33,73,0.452,13,31,0.419354838709677,0.733,20,42,0.476190476190476,"Heat","Miami",240,33,45,13,36,49,19,11,6,26,22,112,15
"team",21900052,"ATL",1610612737,35,83,0.422,11,39,0.282051282051282,0.667,24,44,0.545454545454545,"Hawks","Atlanta",240,16,24,9,24,33,28,14,7,20,29,97,-15
"team",21900053,"DEN",1610612743,43,91,0.473,11,32,0.34375,0.692,32,59,0.542372881355932,"Nuggets","Denver",240,9,13,14,36,50,24,6,1,10,24,106,-3
"team",21900053,"DAL",1610612742,41,84,0.488,13,37,0.351351351351351,0.583,28,47,0.595744680851064,"Mavericks","Dallas",240,14,24,10,32,42,29,6,5,8,14,109,3
"team",21900054,"MEM",1610612763,31,95,0.326,7,34,0.205882352941176,0.957,24,61,0.39344262295082,"Grizzlies","Memphis",240,22,23,13,33,46,20,10,3,21,27,91,-29
"team",21900054,"LAL",1610612747,40,86,0.465,7,26,0.269230769230769,0.846,33,60,0.55,"Lakers","Los Angeles",240,33,39,10,44,54,25,9,8,18,19,120,29
"team",21900055,"CLE",1610612739,41,78,0.526,10,24,0.416666666666667,0.806,31,54,0.574074074074074,"Cavaliers","Cleveland",240,25,31,10,37,47,25,3,7,17,21,117,6
"team",21900055,"CHI",1610612741,39,90,0.433,14,39,0.358974358974359,0.826,25,51,0.490196078431373,"Bulls","Chicago",240,19,23,9,23,32,25,6,5,6,24,111,-6
"team",21900056,"ORL",1610612753,37,88,0.42,12,32,0.375,0.75,25,56,0.446428571428571,"Magic","Orlando",240,9,12,14,38,52,24,5,6,7,17,95,12
"team",21900056,"NYK",1610612752,31,82,0.378,7,31,0.225806451612903,0.7,24,51,0.470588235294118,"Knicks","New York",240,14,20,10,34,44,19,1,10,11,15,83,-12
"team",21900057,"PHI",1610612755,43,92,0.467,9,25,0.36,0.786,34,67,0.507462686567164,"76ers","Philadelphia",240,22,28,16,40,56,24,14,6,22,27,117,22
"team",21900057,"MIN",1610612750,32,81,0.395,10,35,0.285714285714286,0.75,22,46,0.478260869565217,"Timberwolves","Minnesota",240,21,28,6,28,34,12,13,6,21,21,95,-22
"team",21900058,"MIL",1610612749,38,82,0.463,14,45,0.311111111111111,0.625,24,37,0.648648648648649,"Bucks","Milwaukee",240,15,24,5,40,45,21,3,4,15,21,105,-11
"team",21900058,"BOS",1610612738,41,92,0.446,17,41,0.414634146341463,0.81,24,51,0.470588235294118,"Celtics","Boston",240,17,21,5,40,45,25,4,4,9,20,116,11
"team",21900059,"IND",1610612754,45,96,0.469,11,26,0.423076923076923,0.85,34,70,0.485714285714286,"Pacers","Indiana",240,17,20,11,30,41,25,9,2,9,24,118,10
"team",21900059,"BKN",1610612751,41,93,0.441,10,31,0.32258064516129,0.615,31,62,0.5,"Nets","Brooklyn",240,16,26,18,36,54,21,6,5,19,19,108,-10
"team",21900060,"TOR",1610612761,51,86,0.593,13,27,0.481481481481481,0.833,38,59,0.644067796610169,"Raptors","Toronto",240,10,12,3,31,34,30,12,2,14,22,125,12
"team",21900060,"DET",1610612765,41,88,0.466,14,30,0.466666666666667,0.739,27,58,0.46551724137931,"Pistons","Detroit",240,17,23,11,31,42,30,5,1,20,15,113,-12
"team",21900061,"WAS",1610612764,57,91,0.626,20,36,0.555555555555556,0.828,37,55,0.672727272727273,"Wizards","Washington",240,24,29,11,29,40,31,6,4,19,27,158,-1
"team",21900061,"HOU",1610612745,55,103,0.534,23,54,0.425925925925926,0.788,32,49,0.653061224489796,"Rockets","Houston",240,26,33,19,25,44,34,10,5,13,24,159,1
"team",21900062,"POR",1610612757,34,86,0.395,17,35,0.485714285714286,0.708,17,51,0.333333333333333,"Trail Blazers","Portland",240,17,24,9,40,49,19,9,8,17,30,102,3
"team",21900062,"OKC",1610612760,33,84,0.393,4,27,0.148148148148148,0.784,29,57,0.508771929824561,"Thunder","Oklahoma City",240,29,37,13,42,55,15,8,2,18,21,99,-3
"team",21900063,"UTA",1610612762,44,80,0.55,11,24,0.458333333333333,0.688,33,56,0.589285714285714,"Jazz","Utah",240,11,16,3,33,36,23,12,5,14,18,110,14
"team",21900063,"LAC",1610612746,39,82,0.476,8,23,0.347826086956522,0.833,31,59,0.525423728813559,"Clippers","LA",240,10,12,6,30,36,19,3,4,19,22,96,-14
"team",21900064,"SAC",1610612758,44,96,0.458,14,46,0.304347826086957,0.75,30,50,0.6,"Kings","Sacramento",240,9,12,10,29,39,26,11,5,15,19,111,-7
"team",21900064,"CHA",1610612766,46,84,0.548,16,32,0.5,0.714,30,52,0.576923076923077,"Hornets","Charlotte",240,10,14,10,36,46,30,8,3,20,17,118,7
"team",21900065,"PHX",1610612756,44,96,0.458,15,36,0.416666666666667,0.857,29,60,0.483333333333333,"Suns","Phoenix",240,18,21,13,32,45,33,12,4,16,22,121,11
"team",21900065,"GSW",1610612744,36,82,0.439,8,28,0.285714285714286,0.833,28,54,0.518518518518518,"Warriors","Golden State",240,30,36,7,36,43,24,8,6,18,22,110,-11
"team",21900066,"MIA",1610612748,40,84,0.476,14,37,0.378378378378378,0.632,26,47,0.553191489361702,"Heat","Miami",240,12,19,9,32,41,29,12,9,13,18,106,9
"team",21900066,"ATL",1610612737,36,88,0.409,7,34,0.205882352941176,0.692,29,54,0.537037037037037,"Hawks","Atlanta",240,18,26,16,34,50,20,5,5,16,15,97,-9
"team",21900067,"NOP",1610612740,41,77,0.532,15,33,0.454545454545455,0.781,26,44,0.590909090909091,"Pelicans","New Orleans",240,25,32,2,35,37,30,7,4,15,21,122,15
"team",21900067,"DEN",1610612743,43,89,0.483,7,26,0.269230769230769,0.875,36,63,0.571428571428571,"Nuggets","Denver",240,14,16,5,30,35,24,5,3,14,24,107,-15
"team",21900068,"SAS",1610612759,36,80,0.45,7,21,0.333333333333333,0.667,29,59,0.491525423728814,"Spurs","San Antonio",240,18,27,9,40,49,15,6,5,19,28,97,-6
"team",21900068,"LAC",1610612746,39,91,0.429,5,26,0.192307692307692,0.741,34,65,0.523076923076923,"Clippers","LA",240,20,27,11,36,47,16,9,1,11,23,103,6
"team",21900069,"HOU",1610612745,41,99,0.414,12,48,0.25,0.815,29,51,0.568627450980392,"Rockets","Houston",240,22,27,9,31,40,21,13,4,12,21,116,-7
"team",21900069,"BKN",1610612751,42,85,0.494,19,32,0.59375,0.714,23,53,0.433962264150943,"Nets","Brooklyn",240,20,28,10,45,55,26,8,7,20,21,123,7
"team",21900070,"IND",1610612754,39,96,0.406,5,27,0.185185185185185,0.905,34,69,0.492753623188406,"Pacers","Indiana",240,19,21,13,45,58,20,8,10,13,24,102,7
"team",21900070,"CLE",1610612739,32,87,0.368,11,32,0.34375,0.8,21,55,0.381818181818182,"Cavaliers","Cleveland",240,20,25,3,42,45,20,9,1,16,21,95,-7
"team",21900071,"ORL",1610612753,34,91,0.374,12,37,0.324324324324324,0.647,22,54,0.407407407407407,"Magic","Orlando",240,11,17,10,30,40,21,8,3,16,16,91,-32
"team",21900071,"MIL",1610612749,47,93,0.505,17,47,0.361702127659574,0.667,30,46,0.652173913043478,"Bucks","Milwaukee",240,12,18,11,47,58,24,11,4,13,19,123,32
"team",21900072,"NYK",1610612752,37,93,0.398,14,38,0.368421052631579,0.667,23,55,0.418181818181818,"Knicks","New York",240,14,21,16,35,51,22,9,4,13,23,102,-2
"team",21900072,"BOS",1610612738,33,74,0.446,11,34,0.323529411764706,0.931,22,40,0.55,"Celtics","Boston",240,27,29,3,41,44,21,7,4,14,16,104,2
"team",21900073,"DET",1610612765,41,85,0.482,6,29,0.206896551724138,0.75,35,56,0.625,"Pistons","Detroit",240,18,24,10,37,47,21,11,8,16,21,106,-6
"team",21900073,"CHI",1610612741,39,89,0.438,16,40,0.4,0.783,23,49,0.469387755102041,"Bulls","Chicago",240,18,23,11,31,42,29,6,1,17,18,112,6
"team",21900074,"LAL",1610612747,47,96,0.49,9,32,0.28125,0.762,38,64,0.59375,"Lakers","Los Angeles",265,16,21,6,35,41,24,11,7,11,21,119,9
"team",21900074,"DAL",1610612742,40,102,0.392,14,36,0.388888888888889,0.696,26,66,0.393939393939394,"Mavericks","Dallas",265,16,23,18,43,61,23,5,1,22,21,110,-9
"team",21900075,"UTA",1610612762,35,73,0.479,11,28,0.392857142857143,0.741,24,45,0.533333333333333,"Jazz","Utah",240,20,27,6,30,36,18,12,5,17,18,101,-1
"team",21900075,"SAC",1610612758,41,84,0.488,8,29,0.275862068965517,0.706,33,55,0.6,"Kings","Sacramento",240,12,17,11,27,38,15,8,3,16,23,102,1
"team",21900076,"SAS",1610612759,44,93,0.473,13,35,0.371428571428571,0.867,31,58,0.53448275862069,"Spurs","San Antonio",240,26,30,16,36,52,23,4,2,11,19,127,17
"team",21900076,"GSW",1610612744,39,84,0.464,13,28,0.464285714285714,0.905,26,56,0.464285714285714,"Warriors","Golden State",240,19,21,7,32,39,25,4,2,11,22,110,-17
"team",21900077,"OKC",1610612760,41,90,0.456,15,37,0.405405405405405,0.783,26,53,0.490566037735849,"Thunder","Oklahoma City",240,18,23,8,36,44,20,8,11,12,20,115,11
"team",21900077,"NOP",1610612740,40,94,0.426,11,32,0.34375,0.591,29,62,0.467741935483871,"Pelicans","New Orleans",240,13,22,17,39,56,25,7,5,16,25,104,-11
"team",21900078,"DET",1610612765,41,91,0.451,8,27,0.296296296296296,0.793,33,64,0.515625,"Pistons","Detroit",240,23,29,5,36,41,21,8,7,8,18,113,4
"team",21900078,"BKN",1610612751,43,93,0.462,10,32,0.3125,0.765,33,61,0.540983606557377,"Nets","Brooklyn",240,13,17,10,38,48,24,4,4,14,24,109,-4
"team",21900079,"ORL",1610612753,37,86,0.43,6,29,0.206896551724138,0.636,31,57,0.543859649122807,"Magic","Orlando",240,7,11,10,37,47,22,8,7,15,25,87,-4
"team",21900079,"DEN",1610612743,27,73,0.37,9,28,0.321428571428571,0.718,18,45,0.4,"Nuggets","Denver",240,28,39,7,34,41,15,8,3,13,14,91,4
"team",21900080,"WAS",1610612764,37,95,0.389,12,35,0.342857142857143,0.852,25,60,0.416666666666667,"Wizards","Washington",240,23,27,8,31,39,21,11,4,17,18,109,-22
"team",21900080,"MIN",1610612750,51,94,0.543,17,39,0.435897435897436,0.706,34,55,0.618181818181818,"Timberwolves","Minnesota",240,12,17,3,44,47,33,9,10,21,23,131,22
"team",21900081,"PHX",1610612756,44,88,0.5,14,34,0.411764705882353,0.75,30,54,0.555555555555556,"Suns","Phoenix",240,12,16,4,28,32,26,9,2,17,20,114,9
"team",21900081,"MEM",1610612763,42,86,0.488,9,28,0.321428571428571,0.632,33,58,0.568965517241379,"Grizzlies","Memphis",240,12,19,13,33,46,26,9,8,20,23,105,-9
"team",21900082,"TOR",1610612761,34,84,0.405,15,36,0.416666666666667,0.88,19,48,0.395833333333333,"Raptors","Toronto",240,22,25,7,35,42,24,5,6,13,22,105,-10
"team",21900082,"MIL",1610612749,41,89,0.461,13,38,0.342105263157895,0.8,28,51,0.549019607843137,"Bucks","Milwaukee",240,20,25,10,41,51,30,4,7,11,22,115,10
"team",21900083,"GSW",1610612744,34,77,0.442,9,28,0.321428571428571,0.769,25,49,0.510204081632653,"Warriors","Golden State",240,10,13,5,35,40,23,5,5,18,22,87,-6
"team",21900083,"CHA",1610612766,36,85,0.424,5,29,0.172413793103448,0.696,31,56,0.553571428571429,"Hornets","Charlotte",240,16,23,16,32,48,18,6,1,12,15,93,6
"team",21900084,"POR",1610612757,45,78,0.577,19,34,0.558823529411765,0.76,26,44,0.590909090909091,"Trail Blazers","Portland",240,19,25,4,32,36,21,7,4,18,21,128,-1
"team",21900084,"PHI",1610612755,54,107,0.505,11,33,0.333333333333333,0.833,43,74,0.581081081081081,"76ers","Philadelphia",240,10,12,13,33,46,36,11,8,11,23,129,1
"team",21900085,"IND",1610612754,40,85,0.471,8,26,0.307692307692308,0.741,32,59,0.542372881355932,"Pacers","Indiana",240,20,27,10,39,49,28,6,10,16,24,108,13
"team",21900085,"CHI",1610612741,36,84,0.429,9,29,0.310344827586207,0.56,27,55,0.490909090909091,"Bulls","Chicago",240,14,25,6,36,42,27,8,2,18,21,95,-13
"team",21900086,"MIA",1610612748,47,89,0.528,18,41,0.439024390243902,0.773,29,48,0.604166666666667,"Heat","Miami",240,17,22,5,41,46,38,14,7,15,21,129,29
"team",21900086,"HOU",1610612745,31,79,0.392,14,48,0.291666666666667,0.774,17,31,0.548387096774194,"Rockets","Houston",240,24,31,4,34,38,19,6,5,22,24,100,-29
"team",21900087,"SAC",1610612758,41,85,0.482,15,39,0.384615384615385,0.64,26,46,0.565217391304348,"Kings","Sacramento",240,16,25,10,40,50,25,7,5,14,29,113,21
"team",21900087,"NYK",1610612752,32,80,0.4,8,31,0.258064516129032,0.645,24,49,0.489795918367347,"Knicks","New York",240,20,31,9,29,38,18,6,5,13,23,92,-21
"team",21900088,"SAS",1610612759,33,83,0.398,6,25,0.24,0.828,27,58,0.46551724137931,"Spurs","San Antonio",240,24,29,8,39,47,23,11,4,17,18,96,-7
"team",21900088,"LAL",1610612747,42,87,0.483,6,24,0.25,0.684,36,63,0.571428571428571,"Lakers","Los Angeles",240,13,19,7,39,46,21,8,10,18,22,103,7
"team",21900089,"DAL",1610612742,50,94,0.532,20,41,0.48780487804878,0.846,30,53,0.566037735849057,"Mavericks","Dallas",240,11,13,11,40,51,34,5,6,13,21,131,20
"team",21900089,"CLE",1610612739,39,96,0.406,18,48,0.375,0.682,21,48,0.4375,"Cavaliers","Cleveland",240,15,22,12,29,41,24,9,4,9,14,111,-20
"team",21900090,"UTA",1610612762,31,78,0.397,10,31,0.32258064516129,0.71,21,47,0.446808510638298,"Jazz","Utah",240,22,31,6,31,37,16,4,6,14,30,94,-11
"team",21900090,"LAC",1610612746,36,92,0.391,7,32,0.21875,0.765,29,60,0.483333333333333,"Clippers","LA",240,26,34,18,36,54,15,7,6,9,25,105,11
"team",21900091,"WAS",1610612764,43,93,0.462,8,29,0.275862068965517,0.84,35,64,0.546875,"Wizards","Washington",240,21,25,13,28,41,27,9,7,11,23,115,16
"team",21900091,"DET",1610612765,34,82,0.415,13,27,0.481481481481481,0.783,21,55,0.381818181818182,"Pistons","Detroit",240,18,23,13,29,42,21,4,9,19,20,99,-16
"team",21900092,"NOP",1610612740,48,97,0.495,13,32,0.40625,0.762,35,65,0.538461538461538,"Pelicans","New Orleans",240,16,21,10,29,39,18,16,5,21,26,125,-10
"team",21900092,"BKN",1610612751,49,92,0.533,16,41,0.390243902439024,0.75,33,51,0.647058823529412,"Nets","Brooklyn",240,21,28,12,33,45,32,13,3,23,18,135,10
"team",21900093,"MEM",1610612763,40,94,0.426,3,25,0.12,0.81,37,69,0.536231884057971,"Grizzlies","Memphis",240,17,21,13,38,51,19,13,7,14,21,100,-7
"team",21900093,"HOU",1610612745,35,93,0.376,17,50,0.34,0.69,18,43,0.418604651162791,"Rockets","Houston",240,20,29,14,37,51,20,6,5,18,21,107,7
"team",21900094,"MIN",1610612750,37,103,0.359,13,43,0.302325581395349,0.864,24,60,0.4,"Timberwolves","Minnesota",240,19,22,13,34,47,20,12,4,15,23,106,-28
"team",21900094,"MIL",1610612749,50,93,0.538,14,39,0.358974358974359,0.667,36,54,0.666666666666667,"Bucks","Milwaukee",240,20,30,11,46,57,24,8,6,17,20,134,28
"team",21900095,"PHX",1610612756,41,77,0.532,11,28,0.392857142857143,0.778,30,49,0.612244897959184,"Suns","Phoenix",240,21,27,5,35,40,24,6,5,19,24,114,5
"team",21900095,"PHI",1610612755,42,89,0.472,13,29,0.448275862068966,0.6,29,60,0.483333333333333,"76ers","Philadelphia",240,12,20,9,29,38,21,11,2,20,29,109,-5
"team",21900096,"POR",1610612757,47,105,0.448,13,40,0.325,0.786,34,65,0.523076923076923,"Trail Blazers","Portland",240,11,14,16,28,44,16,5,6,6,23,118,-9
"team",21900096,"GSW",1610612744,42,86,0.488,10,26,0.384615384615385,0.917,32,60,0.533333333333333,"Warriors","Golden State",240,33,36,8,39,47,28,4,4,10,17,127,9
"team",21900097,"IND",1610612754,51,94,0.543,12,30,0.4,0.857,39,64,0.609375,"Pacers","Indiana",265,6,7,7,36,43,27,5,7,18,34,120,-2
"team",21900097,"CHA",1610612766,42,88,0.477,10,31,0.32258064516129,0.667,32,57,0.56140350877193,"Hornets","Charlotte",265,28,42,10,27,37,22,7,4,13,17,122,2
"team",21900098,"CLE",1610612739,40,95,0.421,13,33,0.393939393939394,0.909,27,62,0.435483870967742,"Cavaliers","Cleveland",240,20,22,11,32,43,22,3,6,9,18,113,-6
"team",21900098,"BOS",1610612738,48,85,0.565,12,30,0.4,0.733,36,55,0.654545454545455,"Celtics","Boston",240,11,15,4,41,45,24,5,12,14,23,119,6
"team",21900099,"SAS",1610612759,38,91,0.418,8,33,0.242424242424242,0.696,30,58,0.517241379310345,"Spurs","San Antonio",240,16,23,11,30,41,18,9,8,15,17,100,-8
"team",21900099,"ATL",1610612737,43,90,0.478,11,30,0.366666666666667,0.688,32,60,0.533333333333333,"Hawks","Atlanta",240,11,16,9,39,48,22,9,5,18,20,108,8
"team",21900100,"LAL",1610612747,45,92,0.489,11,33,0.333333333333333,0.708,34,59,0.576271186440678,"Lakers","Los Angeles",240,17,24,12,37,49,26,10,10,15,18,118,6
"team",21900100,"CHI",1610612741,43,85,0.506,14,32,0.4375,0.522,29,53,0.547169811320755,"Bulls","Chicago",240,12,23,7,35,42,22,11,4,16,21,112,-6
"team",21900101,"ORL",1610612753,32,82,0.39,3,22,0.136363636363636,0.871,29,60,0.483333333333333,"Magic","Orlando",240,27,31,16,37,53,15,5,8,14,24,94,-8
"team",21900101,"OKC",1610612760,37,86,0.43,12,33,0.363636363636364,0.8,25,53,0.471698113207547,"Thunder","Oklahoma City",240,16,20,7,31,38,21,9,5,9,23,102,8
"team",21900102,"MIA",1610612748,32,88,0.364,9,29,0.310344827586207,0.64,23,59,0.389830508474576,"Heat","Miami",240,16,25,13,31,44,23,12,5,13,21,89,-20
"team",21900102,"DEN",1610612743,45,86,0.523,9,23,0.391304347826087,0.625,36,63,0.571428571428571,"Nuggets","Denver",240,10,16,9,38,47,35,10,3,19,21,109,20
"team",21900103,"NYK",1610612752,39,80,0.487,11,25,0.44,0.619,28,55,0.509090909090909,"Knicks","New York",240,13,21,5,25,30,24,9,4,13,20,102,-20
"team",21900103,"DET",1610612765,44,79,0.557,15,30,0.5,0.792,29,49,0.591836734693878,"Pistons","Detroit",240,19,24,8,35,43,37,7,1,16,17,122,20
"team",21900104,"WAS",1610612764,37,95,0.389,13,40,0.325,1,24,55,0.436363636363636,"Wizards","Washington",240,19,19,16,32,48,24,3,3,16,26,106,-15
"team",21900104,"IND",1610612754,44,94,0.468,12,30,0.4,0.808,32,64,0.5,"Pacers","Indiana",240,21,26,13,35,48,35,8,3,13,25,121,15
"team",21900105,"CHI",1610612741,41,82,0.5,13,33,0.393939393939394,0.667,28,49,0.571428571428571,"Bulls","Chicago",240,18,27,7,36,43,26,11,9,17,30,113,20
"team",21900105,"ATL",1610612737,30,74,0.405,6,30,0.2,0.771,24,44,0.545454545454545,"Hawks","Atlanta",240,27,35,6,35,41,18,7,3,24,26,93,-20
"team",21900106,"TOR",1610612761,43,78,0.551,14,29,0.482758620689655,0.828,29,49,0.591836734693878,"Raptors","Toronto",240,24,29,2,35,37,28,10,4,14,20,124,4
"team",21900106,"SAC",1610612758,42,95,0.442,20,44,0.454545454545455,0.762,22,51,0.431372549019608,"Kings","Sacramento",240,16,21,12,31,43,23,8,7,14,23,120,-4
"team",21900107,"HOU",1610612745,48,97,0.495,21,45,0.466666666666667,0.632,27,52,0.519230769230769,"Rockets","Houston",240,12,19,11,39,50,31,7,9,12,20,129,17
"team",21900107,"GSW",1610612744,38,96,0.396,13,33,0.393939393939394,0.821,25,63,0.396825396825397,"Warriors","Golden State",240,23,28,16,35,51,22,7,1,10,12,112,-17
"team",21900108,"MIN",1610612750,43,96,0.448,16,45,0.355555555555556,0.731,27,51,0.529411764705882,"Timberwolves","Minnesota",240,19,26,10,26,36,29,9,7,11,22,121,-16
"team",21900108,"MEM",1610612763,50,88,0.568,12,23,0.521739130434783,0.833,38,65,0.584615384615385,"Grizzlies","Memphis",240,25,30,8,41,49,34,4,3,17,22,137,16
"team",21900109,"ORL",1610612753,39,80,0.487,6,24,0.25,0.786,33,56,0.589285714285714,"Magic","Orlando",240,22,28,10,34,44,25,14,10,18,30,106,-1
"team",21900109,"DAL",1610612742,36,84,0.429,11,31,0.354838709677419,0.8,25,53,0.471698113207547,"Mavericks","Dallas",240,24,30,12,31,43,20,4,1,17,23,107,1
"team",21900110,"UTA",1610612762,41,89,0.461,8,22,0.363636363636364,0.667,33,67,0.492537313432836,"Jazz","Utah",240,16,24,14,36,50,21,9,4,13,21,106,2
"team",21900110,"PHI",1610612755,33,80,0.412,8,25,0.32,0.882,25,55,0.454545454545455,"76ers","Philadelphia",240,30,34,7,35,42,20,9,3,14,20,104,-2
"team",21900111,"MIL",1610612749,42,98,0.429,18,49,0.36734693877551,0.794,24,49,0.489795918367347,"Bucks","Milwaukee",240,27,34,14,40,54,18,7,11,15,28,129,5
"team",21900111,"LAC",1610612746,41,98,0.418,13,31,0.419354838709677,0.806,28,67,0.417910447761194,"Clippers","LA",240,29,36,14,40,54,21,4,3,19,28,124,-5
"team",21900112,"CHA",1610612766,33,86,0.384,6,31,0.193548387096774,0.714,27,55,0.490909090909091,"Hornets","Charlotte",240,15,21,9,40,49,21,7,9,20,19,87,-21
"team",21900112,"BOS",1610612738,40,93,0.43,10,33,0.303030303030303,0.783,30,60,0.5,"Celtics","Boston",240,18,23,11,41,52,29,13,5,12,19,108,21
"team",21900113,"SAS",1610612759,51,94,0.543,9,20,0.45,0.909,42,74,0.567567567567568,"Spurs","San Antonio",240,10,11,12,35,47,32,5,3,13,21,121,9
"team",21900113,"OKC",1610612760,42,80,0.525,10,21,0.476190476190476,0.75,32,59,0.542372881355932,"Thunder","Oklahoma City",240,18,24,4,27,31,26,7,2,13,14,112,-9
"team",21900114,"PHX",1610612756,37,84,0.44,11,32,0.34375,0.742,26,52,0.5,"Suns","Phoenix",240,23,31,10,30,40,22,4,3,14,21,108,-16
"team",21900114,"MIA",1610612748,45,82,0.549,15,28,0.535714285714286,0.792,30,54,0.555555555555556,"Heat","Miami",240,19,24,5,36,41,22,9,5,13,28,124,16
"team",21900115,"POR",1610612757,39,104,0.375,11,39,0.282051282051282,0.75,28,65,0.430769230769231,"Trail Blazers","Portland",240,12,16,17,34,51,18,7,4,13,27,101,-6
"team",21900115,"LAC",1610612746,39,89,0.438,4,23,0.173913043478261,0.833,35,66,0.53030303030303,"Clippers","LA",240,25,30,13,44,57,20,6,12,17,14,107,6
"team",21900116,"IND",1610612754,43,83,0.518,4,15,0.266666666666667,0.88,39,68,0.573529411764706,"Pacers","Indiana",240,22,25,10,34,44,23,6,8,12,16,112,6
"team",21900116,"DET",1610612765,39,86,0.453,13,33,0.393939393939394,0.833,26,53,0.490566037735849,"Pistons","Detroit",240,15,18,10,30,40,27,6,4,15,26,106,-6
"team",21900117,"ORL",1610612753,44,93,0.473,7,28,0.25,0.852,37,65,0.569230769230769,"Magic","Orlando",240,23,27,12,45,57,24,10,10,9,17,118,32
"team",21900117,"MEM",1610612763,32,86,0.372,11,29,0.379310344827586,0.846,21,57,0.368421052631579,"Grizzlies","Memphis",240,11,13,4,32,36,23,3,5,18,22,86,-32
"team",21900118,"WAS",1610612764,45,96,0.469,7,31,0.225806451612903,0.5,38,65,0.584615384615385,"Wizards","Washington",240,3,6,17,30,47,26,5,5,18,24,100,-13
"team",21900118,"CLE",1610612739,41,90,0.456,6,27,0.222222222222222,0.862,35,63,0.555555555555556,"Cavaliers","Cleveland",240,25,29,17,31,48,18,10,5,12,17,113,13
"team",21900119,"SAC",1610612758,42,76,0.553,18,31,0.580645161290323,0.864,24,45,0.533333333333333,"Kings","Sacramento",240,19,22,9,27,36,27,7,7,14,19,121,12
"team",21900119,"ATL",1610612737,46,87,0.529,9,28,0.321428571428571,0.571,37,59,0.627118644067797,"Hawks","Atlanta",240,8,14,11,23,34,23,8,6,12,19,109,-12
"team",21900120,"MIN",1610612750,48,111,0.432,9,36,0.25,0.69,39,75,0.52,"Timberwolves","Minnesota",265,20,29,20,39,59,20,10,10,18,23,125,6
"team",21900120,"GSW",1610612744,43,103,0.417,10,35,0.285714285714286,0.958,33,68,0.485294117647059,"Warriors","Golden State",265,23,24,13,36,49,18,12,9,20,26,119,-6
"team",21900121,"TOR",1610612761,41,93,0.441,19,43,0.441860465116279,0.875,22,50,0.44,"Raptors","Toronto",240,21,24,10,43,53,27,9,3,17,24,122,18
"team",21900121,"NOP",1610612740,40,99,0.404,10,41,0.24390243902439,0.667,30,58,0.517241379310345,"Pelicans","New Orleans",240,14,21,14,39,53,21,7,6,18,23,104,-18
"team",21900122,"NYK",1610612752,37,89,0.416,14,28,0.5,0.581,23,61,0.377049180327869,"Knicks","New York",240,18,31,14,42,56,19,9,3,12,20,106,4
"team",21900122,"DAL",1610612742,37,90,0.411,14,44,0.318181818181818,0.824,23,46,0.5,"Mavericks","Dallas",240,14,17,7,40,47,18,4,6,13,21,102,-4
"team",21900123,"PHI",1610612755,38,86,0.442,13,26,0.5,0.471,25,60,0.416666666666667,"76ers","Philadelphia",240,8,17,11,38,49,28,8,8,17,19,97,-3
"team",21900123,"DEN",1610612743,39,87,0.448,9,22,0.409090909090909,0.765,30,65,0.461538461538462,"Nuggets","Denver",240,13,17,7,34,41,28,10,11,10,16,100,3
"team",21900124,"UTA",1610612762,34,84,0.405,15,36,0.416666666666667,0.69,19,48,0.395833333333333,"Jazz","Utah",240,20,29,11,45,56,15,3,1,20,27,103,3
"team",21900124,"MIL",1610612749,34,95,0.358,10,36,0.277777777777778,0.733,24,59,0.406779661016949,"Bucks","Milwaukee",240,22,30,16,38,54,14,8,4,12,26,100,-3
"team",21900125,"POR",1610612757,40,97,0.412,11,30,0.366666666666667,0.96,29,67,0.432835820895522,"Trail Blazers","Portland",240,24,25,13,35,48,11,3,9,10,24,115,-4
"team",21900125,"BKN",1610612751,41,99,0.414,16,37,0.432432432432432,0.7,25,62,0.403225806451613,"Nets","Brooklyn",240,21,30,16,35,51,18,6,9,9,25,119,4
"team",21900126,"MIA",1610612748,28,80,0.35,6,35,0.171428571428571,0.75,22,45,0.488888888888889,"Heat","Miami",240,18,24,8,29,37,18,9,2,12,12,80,-15
"team",21900126,"LAL",1610612747,40,89,0.449,8,32,0.25,0.875,32,57,0.56140350877193,"Lakers","Los Angeles",240,7,8,10,38,48,30,6,5,18,24,95,15
"team",21900127,"SAS",1610612759,39,99,0.394,14,30,0.466666666666667,0.767,25,69,0.36231884057971,"Spurs","San Antonio",240,23,30,21,36,57,24,1,8,15,22,115,-20
"team",21900127,"BOS",1610612738,48,94,0.511,14,37,0.378378378378378,0.893,34,57,0.596491228070175,"Celtics","Boston",240,25,28,7,36,43,28,11,11,8,25,135,20
"team",21900128,"NOP",1610612740,40,75,0.533,14,33,0.424242424242424,0.7,26,42,0.619047619047619,"Pelicans","New Orleans",240,21,30,9,36,45,25,13,6,26,28,115,5
"team",21900128,"CHA",1610612766,36,88,0.409,12,35,0.342857142857143,0.765,24,53,0.452830188679245,"Hornets","Charlotte",240,26,34,13,29,42,27,10,2,21,27,110,-5
"team",21900129,"HOU",1610612745,39,83,0.47,19,44,0.431818181818182,0.714,20,39,0.512820512820513,"Rockets","Houston",240,20,28,9,46,55,18,12,7,22,21,117,23
"team",21900129,"CHI",1610612741,37,98,0.378,4,32,0.125,0.889,33,66,0.5,"Bulls","Chicago",240,16,18,11,35,46,21,14,5,15,22,94,-23
"team",21900130,"MEM",1610612763,50,95,0.526,12,36,0.333333333333333,0.714,38,59,0.644067796610169,"Grizzlies","Memphis",240,10,14,10,29,39,31,10,6,15,22,122,-16
"team",21900130,"DAL",1610612742,52,97,0.536,18,42,0.428571428571429,0.8,34,55,0.618181818181818,"Mavericks","Dallas",240,16,20,12,35,47,27,8,5,14,14,138,16
"team",21900131,"OKC",1610612760,43,79,0.544,14,30,0.466666666666667,0.824,29,49,0.591836734693878,"Thunder","Oklahoma City",240,14,17,7,35,42,30,7,5,18,17,114,6
"team",21900131,"GSW",1610612744,42,85,0.494,7,22,0.318181818181818,1,35,63,0.555555555555556,"Warriors","Golden State",240,17,17,6,28,34,22,9,6,15,18,108,-6
"team",21900132,"MIN",1610612750,34,97,0.351,6,45,0.133333333333333,0.727,28,52,0.538461538461538,"Timberwolves","Minnesota",265,24,33,15,38,53,22,9,10,12,23,98,-2
"team",21900132,"DEN",1610612743,39,101,0.386,11,28,0.392857142857143,0.647,28,73,0.383561643835616,"Nuggets","Denver",265,11,17,14,43,57,26,6,4,20,30,100,2
"team",21900133,"ORL",1610612753,41,89,0.461,15,36,0.416666666666667,0.833,26,53,0.490566037735849,"Magic","Orlando",240,5,6,7,30,37,27,5,11,10,10,102,-7
"team",21900133,"IND",1610612754,48,91,0.527,9,20,0.45,0.8,39,71,0.549295774647887,"Pacers","Indiana",240,4,5,10,33,43,31,6,3,9,13,109,7
"team",21900134,"PHI",1610612755,46,84,0.548,10,28,0.357142857142857,0.75,36,56,0.642857142857143,"76ers","Philadelphia",240,12,16,10,39,49,29,9,5,20,16,114,8
"team",21900134,"CHA",1610612766,38,84,0.452,14,33,0.424242424242424,0.727,24,51,0.470588235294118,"Hornets","Charlotte",240,16,22,6,25,31,22,9,1,13,19,106,-8
"team",21900135,"OKC",1610612760,45,91,0.495,17,42,0.404761904761905,0.706,28,49,0.571428571428571,"Thunder","Oklahoma City",240,12,17,5,30,35,31,11,4,15,20,119,-2
"team",21900135,"MIL",1610612749,47,83,0.566,11,28,0.392857142857143,0.889,36,55,0.654545454545455,"Bucks","Milwaukee",240,16,18,5,43,48,27,9,4,22,21,121,2
"team",21900136,"NYK",1610612752,31,86,0.36,9,31,0.290322580645161,0.64,22,55,0.4,"Knicks","New York",240,16,25,17,35,52,19,11,8,21,26,87,-21
"team",21900136,"CLE",1610612739,36,82,0.439,8,28,0.285714285714286,0.903,28,54,0.518518518518518,"Cavaliers","Cleveland",240,28,31,9,36,45,20,11,2,14,19,108,21
"team",21900137,"PHX",1610612756,52,99,0.525,19,42,0.452380952380952,0.789,33,57,0.578947368421053,"Suns","Phoenix",240,15,19,5,37,42,37,8,7,7,17,138,26
"team",21900137,"BKN",1610612751,44,91,0.484,8,34,0.235294117647059,0.941,36,57,0.631578947368421,"Nets","Brooklyn",240,16,17,5,38,43,27,4,2,17,24,112,-26
"team",21900138,"POR",1610612757,45,104,0.433,12,36,0.333333333333333,0.786,33,68,0.485294117647059,"Trail Blazers","Portland",265,22,28,16,45,61,19,10,9,17,22,124,11
"team",21900138,"ATL",1610612737,42,104,0.404,11,41,0.268292682926829,0.72,31,63,0.492063492063492,"Hawks","Atlanta",265,18,25,11,37,48,21,11,8,16,26,113,-11
"team",21900139,"TOR",1610612761,43,89,0.483,12,36,0.333333333333333,0.682,31,53,0.584905660377358,"Raptors","Toronto",240,15,22,7,36,43,26,6,8,13,17,113,9
"team",21900139,"LAL",1610612747,41,94,0.436,10,30,0.333333333333333,0.632,31,64,0.484375,"Lakers","Los Angeles",240,12,19,13,38,51,31,6,7,12,20,104,-9
"team",21900140,"MIN",1610612750,45,89,0.506,15,34,0.441176470588235,0.789,30,55,0.545454545454545,"Timberwolves","Minnesota",240,15,19,11,34,45,25,7,6,16,23,120,6
"team",21900140,"DET",1610612765,39,87,0.448,16,32,0.5,0.8,23,55,0.418181818181818,"Pistons","Detroit",240,20,25,12,27,39,25,9,5,17,22,114,-6
"team",21900141,"DAL",1610612742,37,89,0.416,11,42,0.261904761904762,0.75,26,47,0.553191489361702,"Mavericks","Dallas",240,21,28,13,33,46,22,2,5,6,26,106,-10
"team",21900141,"BOS",1610612738,41,86,0.477,15,35,0.428571428571429,0.76,26,51,0.509803921568627,"Celtics","Boston",240,19,25,10,36,46,25,4,5,9,27,116,10
"team",21900143,"SAS",1610612759,42,90,0.467,12,30,0.4,0.765,30,60,0.5,"Spurs","San Antonio",240,13,17,7,35,42,29,4,4,13,17,109,-4
"team",21900143,"MEM",1610612763,44,87,0.506,11,28,0.392857142857143,0.7,33,59,0.559322033898305,"Grizzlies","Memphis",240,14,20,9,38,47,32,7,5,11,20,113,4
"team",21900142,"NOP",1610612740,41,95,0.432,14,45,0.311111111111111,0.741,27,50,0.54,"Pelicans","New Orleans",240,20,27,12,34,46,26,8,3,16,23,116,-6
"team",21900142,"HOU",1610612745,44,85,0.518,12,41,0.292682926829268,0.688,32,44,0.727272727272727,"Rockets","Houston",240,22,32,7,40,47,16,9,6,17,22,122,6
"team",21900144,"UTA",1610612762,40,81,0.494,16,35,0.457142857142857,0.813,24,46,0.521739130434783,"Jazz","Utah",240,26,32,5,38,43,30,3,3,12,16,122,14
"team",21900144,"GSW",1610612744,45,94,0.479,10,31,0.32258064516129,0.571,35,63,0.555555555555556,"Warriors","Golden State",240,8,14,8,36,44,23,8,2,10,24,108,-14
"team",21900145,"TOR",1610612761,34,85,0.4,11,30,0.366666666666667,0.6,23,55,0.418181818181818,"Raptors","Toronto",240,9,15,5,33,38,25,9,8,15,24,88,-10
"team",21900145,"LAC",1610612746,34,92,0.37,8,36,0.222222222222222,0.733,26,56,0.464285714285714,"Clippers","LA",240,22,30,20,46,66,25,9,7,19,21,98,10
"team",21900146,"OKC",1610612760,29,82,0.354,6,25,0.24,0.875,23,57,0.403508771929825,"Thunder","Oklahoma City",240,21,24,9,31,40,19,9,4,15,16,85,-26
"team",21900146,"IND",1610612754,46,94,0.489,7,23,0.304347826086957,0.923,39,71,0.549295774647887,"Pacers","Indiana",240,12,13,11,39,50,21,6,4,14,20,111,26
"team",21900147,"PHI",1610612755,40,89,0.449,8,38,0.210526315789474,0.769,32,51,0.627450980392157,"76ers","Philadelphia",240,10,13,11,35,46,24,8,8,14,20,98,1
"team",21900147,"CLE",1610612739,38,86,0.442,5,21,0.238095238095238,0.8,33,65,0.507692307692308,"Cavaliers","Cleveland",240,16,20,9,36,45,13,10,0,13,13,97,-1
"team",21900148,"MIA",1610612748,41,77,0.532,14,32,0.4375,0.778,27,45,0.6,"Heat","Miami",240,21,27,8,34,42,34,6,1,19,30,117,9
"team",21900148,"DET",1610612765,34,78,0.436,15,41,0.365853658536585,0.676,19,37,0.513513513513513,"Pistons","Detroit",240,25,37,8,24,32,27,9,9,16,28,108,-9
"team",21900149,"NYK",1610612752,36,88,0.409,10,32,0.3125,0.645,26,56,0.464285714285714,"Knicks","New York",240,20,31,13,25,38,27,12,1,18,28,102,-18
"team",21900149,"CHI",1610612741,41,81,0.506,14,33,0.424242424242424,0.774,27,48,0.5625,"Bulls","Chicago",240,24,31,9,37,46,22,9,2,19,25,120,18
"team",21900150,"DEN",1610612743,46,104,0.442,11,41,0.268292682926829,0.818,35,63,0.555555555555556,"Nuggets","Denver",240,18,22,15,25,40,31,7,5,3,24,121,-4
"team",21900150,"ATL",1610612737,44,83,0.53,15,34,0.441176470588235,0.647,29,49,0.591836734693878,"Hawks","Atlanta",240,22,34,10,35,45,30,1,5,14,21,125,4
"team",21900151,"PHX",1610612756,43,91,0.473,16,38,0.421052631578947,0.765,27,53,0.509433962264151,"Suns","Phoenix",240,13,17,6,33,39,32,3,4,11,22,115,-8
"team",21900151,"LAL",1610612747,51,95,0.537,10,25,0.4,0.524,41,70,0.585714285714286,"Lakers","Los Angeles",240,11,21,8,36,44,39,4,4,9,21,123,8
"team",21900152,"UTA",1610612762,43,92,0.467,6,26,0.230769230769231,0.771,37,66,0.560606060606061,"Jazz","Utah",240,27,35,11,35,46,16,7,4,11,18,119,5
"team",21900152,"BKN",1610612751,41,90,0.456,11,37,0.297297297297297,0.84,30,53,0.566037735849057,"Nets","Brooklyn",240,21,25,10,33,43,19,5,8,16,29,114,-5
"team",21900153,"SAC",1610612758,38,86,0.442,11,32,0.34375,0.769,27,54,0.5,"Kings","Sacramento",240,20,26,11,35,46,24,9,5,14,25,107,8
"team",21900153,"POR",1610612757,34,77,0.442,8,30,0.266666666666667,0.767,26,47,0.553191489361702,"Trail Blazers","Portland",240,23,30,7,33,40,15,4,5,17,19,99,-8
"team",21900154,"MEM",1610612763,48,89,0.539,17,35,0.485714285714286,0.667,31,54,0.574074074074074,"Grizzlies","Memphis",240,6,9,11,34,45,32,9,5,23,21,119,2
"team",21900154,"CHA",1610612766,43,87,0.494,16,36,0.444444444444444,0.789,27,51,0.529411764705882,"Hornets","Charlotte",240,15,19,7,27,34,27,8,5,15,12,117,-2
"team",21900155,"PHI",1610612755,40,91,0.44,8,30,0.266666666666667,0.692,32,61,0.524590163934426,"76ers","Philadelphia",240,9,13,8,39,47,25,5,5,15,27,97,-15
"team",21900155,"ORL",1610612753,38,86,0.442,10,32,0.3125,0.765,28,54,0.518518518518518,"Magic","Orlando",240,26,34,9,39,48,27,6,2,13,22,112,15
"team",21900156,"WAS",1610612764,50,96,0.521,11,29,0.379310344827586,0.815,39,67,0.582089552238806,"Wizards","Washington",240,22,27,9,27,36,28,5,4,8,23,133,-7
"team",21900156,"BOS",1610612738,49,96,0.51,16,36,0.444444444444444,0.897,33,60,0.55,"Celtics","Boston",240,26,29,10,34,44,32,5,5,11,26,140,7
"team",21900157,"LAC",1610612746,38,98,0.388,10,33,0.303030303030303,0.5,28,65,0.430769230769231,"Clippers","LA",240,7,14,11,42,53,17,3,3,13,21,93,-9
"team",21900157,"HOU",1610612745,33,86,0.384,14,42,0.333333333333333,0.815,19,44,0.431818181818182,"Rockets","Houston",240,22,27,9,44,53,12,7,6,10,17,102,9
"team",21900158,"SAS",1610612759,44,90,0.489,3,17,0.176470588235294,0.793,41,73,0.561643835616438,"Spurs","San Antonio",240,23,29,10,34,44,24,4,4,11,23,114,-15
"team",21900158,"MIN",1610612750,45,91,0.495,11,34,0.323529411764706,0.824,34,57,0.596491228070175,"Timberwolves","Minnesota",240,28,34,13,37,50,25,11,4,10,25,129,15
"team",21900159,"LAL",1610612747,48,89,0.539,9,20,0.45,0.833,39,69,0.565217391304348,"Lakers","Los Angeles",240,15,18,13,38,51,31,8,6,19,18,120,26
"team",21900159,"GSW",1610612744,36,89,0.404,9,35,0.257142857142857,0.765,27,54,0.5,"Warriors","Golden State",240,13,17,10,23,33,29,8,7,17,14,94,-26
"team",21900160,"TOR",1610612761,42,92,0.457,14,32,0.4375,0.941,28,60,0.466666666666667,"Raptors","Toronto",240,16,17,14,36,50,20,4,9,12,20,114,8
"team",21900160,"POR",1610612757,38,96,0.396,17,48,0.354166666666667,0.813,21,48,0.4375,"Trail Blazers","Portland",240,13,16,11,32,43,24,3,7,12,16,106,-8
"team",21900161,"MIA",1610612748,43,79,0.544,12,30,0.4,0.909,31,49,0.63265306122449,"Heat","Miami",240,10,11,4,37,41,31,10,7,18,21,108,11
"team",21900161,"CLE",1610612739,36,85,0.424,8,32,0.25,0.81,28,53,0.528301886792453,"Cavaliers","Cleveland",240,17,21,11,30,41,18,14,2,18,16,97,-11
"team",21900162,"NYK",1610612752,42,94,0.447,13,30,0.433333333333333,0.818,29,64,0.453125,"Knicks","New York",240,9,11,15,38,53,20,6,2,15,27,106,3
"team",21900162,"DAL",1610612742,36,84,0.429,8,36,0.222222222222222,0.742,28,48,0.583333333333333,"Mavericks","Dallas",240,23,31,12,32,44,21,8,7,11,16,103,-3
"team",21900163,"MIL",1610612749,42,88,0.477,6,33,0.181818181818182,0.723,36,55,0.654545454545455,"Bucks","Milwaukee",240,34,47,17,41,58,24,9,4,22,22,124,9
"team",21900163,"CHI",1610612741,38,93,0.409,18,43,0.418604651162791,0.84,20,50,0.4,"Bulls","Chicago",240,21,25,10,35,45,25,14,1,20,29,115,-9
"team",21900164,"NOP",1610612740,47,98,0.48,18,34,0.529411764705882,0.69,29,64,0.453125,"Pelicans","New Orleans",240,20,29,18,33,51,26,11,5,14,25,132,5
"team",21900164,"LAC",1610612746,46,84,0.548,11,24,0.458333333333333,0.774,35,60,0.583333333333333,"Clippers","LA",240,24,31,6,31,37,28,6,6,16,22,127,-5
"team",21900165,"PHX",1610612756,41,85,0.482,15,39,0.384615384615385,0.816,26,46,0.565217391304348,"Suns","Phoenix",240,31,38,7,32,39,32,6,2,20,24,128,16
"team",21900165,"ATL",1610612737,40,91,0.44,8,31,0.258064516129032,0.8,32,60,0.533333333333333,"Hawks","Atlanta",240,24,30,15,34,49,25,15,5,22,31,112,-16
"team",21900166,"DEN",1610612743,43,101,0.426,10,33,0.303030303030303,0.5,33,68,0.485294117647059,"Nuggets","Denver",240,5,10,14,48,62,26,4,3,7,14,101,8
"team",21900166,"BKN",1610612751,36,95,0.379,8,38,0.210526315789474,0.813,28,57,0.491228070175439,"Nets","Brooklyn",240,13,16,7,44,51,19,3,2,7,14,93,-8
"team",21900167,"DET",1610612765,40,81,0.494,15,35,0.428571428571429,1,25,46,0.543478260869565,"Pistons","Detroit",240,11,11,7,35,42,25,3,3,19,19,106,-3
"team",21900167,"CHA",1610612766,43,96,0.448,13,35,0.371428571428571,0.625,30,61,0.491803278688525,"Hornets","Charlotte",240,10,16,14,27,41,22,10,3,10,17,109,3
"team",21900168,"SAS",1610612759,45,89,0.506,13,26,0.5,0.6,32,63,0.507936507936508,"Spurs","San Antonio",240,6,10,8,33,41,23,8,8,11,25,109,-2
"team",21900168,"ORL",1610612753,36,87,0.414,12,29,0.413793103448276,0.794,24,58,0.413793103448276,"Magic","Orlando",240,27,34,14,34,48,22,6,5,10,13,111,2
"team",21900169,"IND",1610612754,37,82,0.451,8,33,0.242424242424242,0.769,29,49,0.591836734693878,"Pacers","Indiana",240,20,26,8,34,42,24,2,2,16,25,102,-9
"team",21900169,"HOU",1610612745,36,89,0.404,14,46,0.304347826086957,0.862,22,43,0.511627906976744,"Rockets","Houston",240,25,29,10,34,44,12,11,3,8,23,111,9
"team",21900170,"UTA",1610612762,35,87,0.402,9,34,0.264705882352941,0.844,26,53,0.490566037735849,"Jazz","Utah",240,27,32,9,36,45,17,5,6,14,16,106,-1
"team",21900170,"MEM",1610612763,43,96,0.448,10,35,0.285714285714286,0.846,33,61,0.540983606557377,"Grizzlies","Memphis",240,11,13,9,37,46,25,6,5,11,23,107,1
"team",21900171,"WAS",1610612764,54,100,0.54,10,28,0.357142857142857,0.76,44,72,0.611111111111111,"Wizards","Washington",240,19,25,13,38,51,38,10,5,13,22,137,21
"team",21900171,"MIN",1610612750,42,89,0.472,11,37,0.297297297297297,0.724,31,52,0.596153846153846,"Timberwolves","Minnesota",240,21,29,9,34,43,26,6,5,20,20,116,-21
"team",21900172,"PHI",1610612755,45,90,0.5,14,32,0.4375,0.682,31,58,0.53448275862069,"76ers","Philadelphia",265,15,22,13,30,43,24,6,0,14,32,119,-8
"team",21900172,"OKC",1610612760,41,76,0.539,10,24,0.416666666666667,0.854,31,52,0.596153846153846,"Thunder","Oklahoma City",265,35,41,6,30,36,22,7,3,13,23,127,8
"team",21900173,"GSW",1610612744,34,82,0.415,5,28,0.178571428571429,0.794,29,54,0.537037037037037,"Warriors","Golden State",240,27,34,12,43,55,17,8,4,19,19,100,-5
"team",21900173,"BOS",1610612738,37,91,0.407,13,33,0.393939393939394,0.783,24,58,0.413793103448276,"Celtics","Boston",240,18,23,11,36,47,24,13,5,14,24,105,5
"team",21900174,"SAC",1610612758,36,82,0.439,16,39,0.41025641025641,1,20,43,0.465116279069767,"Kings","Sacramento",240,9,9,10,33,43,24,7,0,17,22,97,-2
"team",21900174,"LAL",1610612747,34,81,0.42,11,37,0.297297297297297,0.909,23,44,0.522727272727273,"Lakers","Los Angeles",240,20,22,10,31,41,22,11,6,13,18,99,2
"team",21900175,"CHI",1610612741,32,91,0.352,9,39,0.230769230769231,0.927,23,52,0.442307692307692,"Bulls","Chicago",240,38,41,17,39,56,15,8,2,19,30,111,-6
"team",21900175,"BKN",1610612751,40,88,0.455,10,43,0.232558139534884,0.871,30,45,0.666666666666667,"Nets","Brooklyn",240,27,31,5,35,40,30,10,9,15,30,117,6
"team",21900176,"MIL",1610612749,43,96,0.448,11,39,0.282051282051282,0.714,32,57,0.56140350877193,"Bucks","Milwaukee",240,5,7,8,47,55,23,6,8,14,13,102,19
"team",21900176,"IND",1610612754,32,100,0.32,12,34,0.352941176470588,0.778,20,66,0.303030303030303,"Pacers","Indiana",240,7,9,14,40,54,19,8,7,13,10,83,-19
"team",21900177,"NYK",1610612752,39,86,0.453,6,20,0.3,0.783,33,66,0.5,"Knicks","New York",240,18,23,13,35,48,22,5,1,11,21,102,-1
"team",21900177,"CHA",1610612766,36,87,0.414,17,48,0.354166666666667,0.737,19,39,0.487179487179487,"Hornets","Charlotte",240,14,19,12,30,42,22,5,3,10,18,103,1
"team",21900178,"NOP",1610612740,37,82,0.451,16,35,0.457142857142857,0.667,21,47,0.446808510638298,"Pelicans","New Orleans",240,4,6,7,24,31,23,10,2,18,16,94,-15
"team",21900178,"MIA",1610612748,44,81,0.543,9,24,0.375,0.923,35,57,0.614035087719298,"Heat","Miami",240,12,13,9,36,45,25,13,3,20,6,109,15
"team",21900179,"MIN",1610612750,38,84,0.452,12,38,0.315789473684211,0.739,26,46,0.565217391304348,"Timberwolves","Minnesota",240,17,23,13,33,46,23,7,5,18,20,105,-20
"team",21900179,"HOU",1610612745,43,94,0.457,19,49,0.387755102040816,0.909,24,45,0.533333333333333,"Rockets","Houston",240,20,22,14,28,42,15,7,3,12,18,125,20
"team",21900180,"TOR",1610612761,37,89,0.416,17,41,0.414634146341463,0.733,20,48,0.416666666666667,"Raptors","Toronto",240,11,15,7,35,42,21,7,2,14,20,102,-8
"team",21900180,"DAL",1610612742,37,88,0.42,9,39,0.230769230769231,0.818,28,49,0.571428571428571,"Mavericks","Dallas",240,27,33,12,43,55,24,7,4,12,15,110,8
"team",21900181,"SAS",1610612759,41,88,0.466,5,18,0.277777777777778,0.853,36,70,0.514285714285714,"Spurs","San Antonio",240,29,34,7,36,43,25,8,7,10,17,116,-5
"team",21900181,"POR",1610612757,42,93,0.452,13,39,0.333333333333333,0.923,29,54,0.537037037037037,"Trail Blazers","Portland",240,24,26,9,39,48,21,2,4,12,20,121,5
"team",21900182,"LAC",1610612746,50,93,0.538,17,33,0.515151515151515,0.943,33,60,0.55,"Clippers","LA",240,33,35,12,41,53,30,10,12,19,28,150,49
"team",21900182,"ATL",1610612737,34,90,0.378,6,24,0.25,0.73,28,66,0.424242424242424,"Hawks","Atlanta",240,27,37,14,24,38,19,11,10,19,27,101,-49
"team",21900183,"PHI",1610612755,46,84,0.548,9,23,0.391304347826087,0.765,37,61,0.60655737704918,"76ers","Philadelphia",240,13,17,4,40,44,33,6,11,13,22,114,19
"team",21900183,"CLE",1610612739,34,90,0.378,6,25,0.24,0.875,28,65,0.430769230769231,"Cavaliers","Cleveland",240,21,24,11,31,42,14,9,5,14,21,95,-19
"team",21900184,"SAC",1610612758,38,89,0.427,14,35,0.4,0.833,24,54,0.444444444444444,"Kings","Sacramento",240,10,12,10,35,45,22,8,7,12,24,100,1
"team",21900184,"BOS",1610612738,34,82,0.415,10,30,0.333333333333333,0.875,24,52,0.461538461538462,"Celtics","Boston",240,21,24,10,36,46,26,7,3,14,14,99,-1
"team",21900185,"WAS",1610612764,46,97,0.474,19,41,0.463414634146341,0.833,27,56,0.482142857142857,"Wizards","Washington",240,10,12,9,29,38,31,7,2,9,21,121,-4
"team",21900185,"ORL",1610612753,43,87,0.494,15,38,0.394736842105263,0.923,28,49,0.571428571428571,"Magic","Orlando",240,24,26,11,41,52,25,5,3,14,15,125,4
"team",21900186,"MEM",1610612763,39,84,0.464,16,36,0.444444444444444,0.833,23,48,0.479166666666667,"Grizzlies","Memphis",240,20,24,9,36,45,29,4,3,16,17,114,-17
"team",21900186,"DEN",1610612743,49,89,0.551,18,32,0.5625,0.652,31,57,0.543859649122807,"Nuggets","Denver",240,15,23,6,33,39,36,10,10,12,24,131,17
"team",21900187,"NOP",1610612740,37,89,0.416,18,46,0.391304347826087,0.8,19,43,0.441860465116279,"Pelicans","New Orleans",240,16,20,11,37,48,24,3,5,13,21,108,8
"team",21900187,"GSW",1610612744,37,91,0.407,7,25,0.28,0.826,30,66,0.454545454545455,"Warriors","Golden State",240,19,23,9,34,43,23,7,3,10,19,100,-8
"team",21900188,"LAL",1610612747,47,89,0.528,15,35,0.428571428571429,0.813,32,54,0.592592592592593,"Lakers","Los Angeles",240,13,16,10,32,42,26,10,14,16,19,122,21
"team",21900188,"ATL",1610612737,37,86,0.43,8,28,0.285714285714286,0.76,29,58,0.5,"Hawks","Atlanta",240,19,25,9,28,37,16,11,2,18,19,101,-21
"team",21900189,"NYK",1610612752,44,98,0.449,8,23,0.347826086956522,0.771,36,75,0.48,"Knicks","New York",240,27,35,19,28,47,17,8,10,7,24,123,18
"team",21900189,"CLE",1610612739,36,76,0.474,17,36,0.472222222222222,0.533,19,40,0.475,"Cavaliers","Cleveland",240,16,30,10,31,41,18,2,1,19,26,105,-18
"team",21900190,"IND",1610612754,44,101,0.436,14,33,0.424242424242424,0.765,30,68,0.441176470588235,"Pacers","Indiana",240,13,17,15,48,63,26,5,8,10,22,115,29
"team",21900190,"BKN",1610612751,30,84,0.357,11,34,0.323529411764706,0.625,19,50,0.38,"Nets","Brooklyn",240,15,24,4,36,40,18,2,7,9,19,86,-29
"team",21900191,"TOR",1610612761,50,97,0.515,20,43,0.465116279069767,0.8,30,54,0.555555555555556,"Raptors","Toronto",240,12,15,16,37,53,40,13,2,10,25,132,36
"team",21900191,"CHA",1610612766,33,78,0.423,15,45,0.333333333333333,0.625,18,33,0.545454545454545,"Hornets","Charlotte",240,15,24,9,28,37,26,3,8,19,19,96,-36
"team",21900192,"MIL",1610612749,38,82,0.463,15,41,0.365853658536585,0.686,23,41,0.560975609756098,"Bucks","Milwaukee",240,24,35,8,40,48,24,12,9,15,16,115,14
"team",21900192,"CHI",1610612741,39,97,0.402,12,34,0.352941176470588,0.786,27,63,0.428571428571429,"Bulls","Chicago",240,11,14,13,37,50,25,6,6,14,25,101,-14
"team",21900193,"POR",1610612757,40,96,0.417,11,36,0.305555555555556,0.739,29,60,0.483333333333333,"Trail Blazers","Portland",240,17,23,12,32,44,28,7,5,17,21,108,-24
"team",21900193,"HOU",1610612745,47,100,0.47,17,45,0.377777777777778,0.808,30,55,0.545454545454545,"Rockets","Houston",240,21,26,17,41,58,24,9,10,16,21,132,24
"team",21900194,"SAS",1610612759,44,96,0.458,8,24,0.333333333333333,0.875,36,72,0.5,"Spurs","San Antonio",240,14,16,17,31,48,18,6,2,9,18,110,-7
"team",21900194,"DAL",1610612742,42,84,0.5,17,41,0.414634146341463,0.696,25,43,0.581395348837209,"Mavericks","Dallas",240,16,23,9,32,41,28,4,3,13,19,117,7
"team",21900195,"PHX",1610612756,33,82,0.402,10,36,0.277777777777778,0.75,23,46,0.5,"Suns","Phoenix",240,9,12,8,37,45,22,7,6,19,17,85,-14
"team",21900195,"BOS",1610612738,37,89,0.416,12,41,0.292682926829268,0.765,25,48,0.520833333333333,"Celtics","Boston",240,13,17,11,41,52,22,12,5,17,21,99,14
"team",21900196,"UTA",1610612762,35,96,0.365,12,31,0.387096774193548,0.769,23,65,0.353846153846154,"Jazz","Utah",240,20,26,12,41,53,20,5,5,14,23,102,-10
"team",21900196,"MIN",1610612750,41,89,0.461,14,38,0.368421052631579,0.842,27,51,0.529411764705882,"Timberwolves","Minnesota",240,16,19,5,46,51,22,6,10,15,25,112,10
"team",21900197,"OKC",1610612760,28,75,0.373,7,27,0.259259259259259,0.893,21,48,0.4375,"Thunder","Oklahoma City",240,25,28,9,36,45,17,12,4,17,19,88,-2
"team",21900197,"LAC",1610612746,35,87,0.402,10,36,0.277777777777778,0.714,25,51,0.490196078431373,"Clippers","LA",240,10,14,13,36,49,23,7,5,17,25,90,2
"team",21900198,"MEM",1610612763,36,88,0.409,9,25,0.36,0.737,27,63,0.428571428571429,"Grizzlies","Memphis",240,14,19,7,30,37,26,6,4,12,23,95,-19
"team",21900198,"GSW",1610612744,43,90,0.478,9,29,0.310344827586207,0.864,34,61,0.557377049180328,"Warriors","Golden State",240,19,22,11,40,51,33,5,10,14,24,114,19
"team",21900199,"POR",1610612757,40,92,0.435,16,29,0.551724137931034,0.615,24,63,0.380952380952381,"Trail Blazers","Portland",240,8,13,11,37,48,20,5,4,17,23,104,-11
"team",21900199,"NOP",1610612740,41,93,0.441,13,36,0.361111111111111,0.833,28,57,0.491228070175439,"Pelicans","New Orleans",240,20,24,16,37,53,24,10,5,13,15,115,11
"team",21900200,"SAC",1610612758,42,79,0.532,13,31,0.419354838709677,0.92,29,48,0.604166666666667,"Kings","Sacramento",240,23,25,8,35,43,28,7,7,18,26,120,4
"team",21900200,"PHX",1610612756,38,89,0.427,12,36,0.333333333333333,0.824,26,53,0.490566037735849,"Suns","Phoenix",240,28,34,14,25,39,24,11,4,10,20,116,-4
"team",21900201,"OKC",1610612760,38,80,0.475,9,28,0.321428571428571,0.88,29,52,0.557692307692308,"Thunder","Oklahoma City",240,22,25,8,31,39,22,10,2,15,22,107,-5
"team",21900201,"LAL",1610612747,43,89,0.483,14,31,0.451612903225806,0.632,29,58,0.5,"Lakers","Los Angeles",240,12,19,14,32,46,29,9,8,16,20,112,5
"team",21900202,"PHI",1610612755,39,89,0.438,13,32,0.40625,0.692,26,57,0.456140350877193,"76ers","Philadelphia",240,18,26,10,34,44,30,5,5,10,14,109,5
"team",21900202,"NYK",1610612752,40,84,0.476,13,25,0.52,0.733,27,59,0.457627118644068,"Knicks","New York",240,11,15,7,35,42,17,8,6,14,25,104,-5
"team",21900203,"WAS",1610612764,54,92,0.587,18,30,0.6,0.8,36,62,0.580645161290323,"Wizards","Washington",240,12,15,6,32,38,37,4,3,17,20,138,6
"team",21900203,"SAS",1610612759,49,93,0.527,12,32,0.375,0.759,37,61,0.60655737704918,"Spurs","San Antonio",240,22,29,12,29,41,32,8,8,12,13,132,-6
"team",21900204,"MIL",1610612749,46,87,0.529,17,43,0.395348837209302,0.765,29,44,0.659090909090909,"Bucks","Milwaukee",240,26,34,8,38,46,25,6,8,19,25,135,8
"team",21900204,"ATL",1610612737,44,96,0.458,14,31,0.451612903225806,0.806,30,65,0.461538461538462,"Hawks","Atlanta",240,25,31,9,34,43,27,8,2,13,26,127,-8
"team",21900205,"CHA",1610612766,30,81,0.37,11,33,0.333333333333333,0.769,19,48,0.395833333333333,"Hornets","Charlotte",240,20,26,8,33,41,17,8,3,16,23,91,-10
"team",21900205,"BKN",1610612751,36,90,0.4,10,39,0.256410256410256,0.826,26,51,0.509803921568627,"Nets","Brooklyn",240,19,23,13,40,53,19,11,1,15,21,101,10
"team",21900206,"MIA",1610612748,41,78,0.526,19,37,0.513513513513513,0.742,22,41,0.536585365853659,"Heat","Miami",240,23,31,12,32,44,25,8,5,23,20,124,24
"team",21900206,"CLE",1610612739,37,87,0.425,12,38,0.315789473684211,0.875,25,49,0.510204081632653,"Cavaliers","Cleveland",240,14,16,10,24,34,19,13,2,19,23,100,-24
"team",21900207,"TOR",1610612761,45,87,0.517,9,27,0.333333333333333,0.737,36,60,0.6,"Raptors","Toronto",240,14,19,10,37,47,26,5,5,11,21,113,16
"team",21900207,"ORL",1610612753,35,91,0.385,9,32,0.28125,0.643,26,59,0.440677966101695,"Magic","Orlando",240,18,28,16,27,43,26,9,8,11,16,97,-16
"team",21900208,"GSW",1610612744,35,90,0.389,8,27,0.296296296296296,0.64,27,63,0.428571428571429,"Warriors","Golden State",240,16,25,9,25,34,18,7,5,9,16,94,-48
"team",21900208,"DAL",1610612742,51,90,0.567,22,38,0.578947368421053,0.783,29,52,0.557692307692308,"Mavericks","Dallas",240,18,23,8,42,50,33,7,7,11,21,142,48
"team",21900209,"DET",1610612765,28,83,0.337,8,33,0.242424242424242,0.781,20,50,0.4,"Pistons","Detroit",240,25,32,12,34,46,23,6,8,16,20,89,-20
"team",21900209,"CHI",1610612741,39,91,0.429,14,27,0.518518518518518,0.654,25,64,0.390625,"Bulls","Chicago",240,17,26,12,43,55,25,9,7,14,24,109,20
"team",21900210,"UTA",1610612762,35,86,0.407,14,33,0.424242424242424,0.704,21,53,0.39622641509434,"Jazz","Utah",240,19,27,13,38,51,22,7,6,11,21,103,8
"team",21900210,"MIN",1610612750,35,89,0.393,14,45,0.311111111111111,0.524,21,44,0.477272727272727,"Timberwolves","Minnesota",240,11,21,12,39,51,13,5,9,13,20,95,-8
"team",21900211,"HOU",1610612745,32,76,0.421,12,38,0.315789473684211,0.76,20,38,0.526315789473684,"Rockets","Houston",240,19,25,9,34,43,19,9,2,20,22,95,-10
"team",21900211,"DEN",1610612743,44,94,0.468,9,27,0.333333333333333,0.533,35,67,0.522388059701492,"Nuggets","Denver",240,8,15,15,33,48,29,13,4,14,21,105,10
"team",21900212,"LAC",1610612746,39,93,0.419,17,45,0.377777777777778,0.75,22,48,0.458333333333333,"Clippers","LA",265,12,16,14,39,53,26,12,9,23,18,107,3
"team",21900212,"BOS",1610612738,41,104,0.394,12,45,0.266666666666667,0.714,29,59,0.491525423728814,"Celtics","Boston",265,10,14,18,35,53,26,11,2,17,22,104,-3
"team",21900213,"POR",1610612757,50,103,0.485,17,39,0.435897435897436,0.857,33,64,0.515625,"Trail Blazers","Portland",240,12,14,9,32,41,32,6,11,8,27,129,-8
"team",21900213,"MIL",1610612749,50,106,0.472,16,43,0.372093023255814,0.808,34,63,0.53968253968254,"Bucks","Milwaukee",240,21,26,18,40,58,32,7,3,12,20,137,8
"team",21900214,"PHX",1610612756,40,86,0.465,13,31,0.419354838709677,0.875,27,55,0.490909090909091,"Suns","Phoenix",240,28,32,9,29,38,28,10,3,14,19,121,-3
"team",21900214,"NOP",1610612740,47,88,0.534,16,35,0.457142857142857,0.636,31,53,0.584905660377358,"Pelicans","New Orleans",240,14,22,8,36,44,28,8,6,17,25,124,3
"team",21900215,"DET",1610612765,49,82,0.598,17,34,0.5,0.65,32,48,0.666666666666667,"Pistons","Detroit",240,13,20,12,30,42,30,13,10,18,17,128,25
"team",21900215,"ATL",1610612737,38,88,0.432,10,37,0.27027027027027,1,28,51,0.549019607843137,"Hawks","Atlanta",240,17,17,10,24,34,26,12,2,19,18,103,-25
"team",21900216,"WAS",1610612764,48,91,0.527,14,34,0.411764705882353,0.75,34,57,0.596491228070175,"Wizards","Washington",240,15,20,6,35,41,34,10,3,11,13,125,7
"team",21900216,"CHA",1610612766,48,93,0.516,14,34,0.411764705882353,1,34,59,0.576271186440678,"Hornets","Charlotte",240,8,8,7,37,44,24,9,5,16,18,118,-7
"team",21900217,"SAC",1610612758,39,86,0.453,4,26,0.153846153846154,0.789,35,60,0.583333333333333,"Kings","Sacramento",240,15,19,7,26,33,26,8,2,16,25,97,-19
"team",21900217,"BKN",1610612751,41,81,0.506,12,34,0.352941176470588,0.71,29,47,0.617021276595745,"Nets","Brooklyn",240,22,31,13,35,48,22,9,3,18,18,116,19
"team",21900218,"SAS",1610612759,43,85,0.506,6,18,0.333333333333333,0.75,37,67,0.552238805970149,"Spurs","San Antonio",240,12,16,3,29,32,21,6,3,11,15,104,-11
"team",21900218,"PHI",1610612755,46,89,0.517,10,26,0.384615384615385,0.684,36,63,0.571428571428571,"76ers","Philadelphia",240,13,19,13,38,51,32,8,4,15,21,115,11
"team",21900219,"MIA",1610612748,39,79,0.494,14,38,0.368421052631579,0.857,25,41,0.609756097560976,"Heat","Miami",240,24,28,9,35,44,33,10,3,19,17,116,8
"team",21900219,"CHI",1610612741,41,90,0.456,10,30,0.333333333333333,0.8,31,60,0.516666666666667,"Bulls","Chicago",240,16,20,14,27,41,23,11,3,13,24,108,-8
"team",21900220,"OKC",1610612760,49,93,0.527,11,31,0.354838709677419,0.9,38,62,0.612903225806452,"Thunder","Oklahoma City",240,18,20,6,31,37,28,8,3,11,23,127,-3
"team",21900220,"LAL",1610612747,45,88,0.511,17,31,0.548387096774194,0.793,28,57,0.491228070175439,"Lakers","Los Angeles",240,23,29,11,34,45,32,7,6,15,20,130,3
"team",21900221,"DAL",1610612742,58,100,0.58,20,37,0.540540540540541,0.778,38,63,0.603174603174603,"Mavericks","Dallas",240,7,9,10,39,49,31,8,7,5,18,143,42
"team",21900221,"CLE",1610612739,37,86,0.43,12,29,0.413793103448276,0.882,25,57,0.43859649122807,"Cavaliers","Cleveland",240,15,17,8,26,34,23,3,3,10,15,101,-42
"team",21900222,"DEN",1610612743,39,88,0.443,7,28,0.25,0.846,32,60,0.533333333333333,"Nuggets","Denver",240,11,13,11,37,48,24,7,5,17,17,96,4
"team",21900222,"BOS",1610612738,33,81,0.407,7,27,0.259259259259259,0.826,26,54,0.481481481481481,"Celtics","Boston",240,19,23,5,35,40,21,12,6,11,19,92,-4
"team",21900223,"UTA",1610612762,43,85,0.506,14,32,0.4375,0.813,29,53,0.547169811320755,"Jazz","Utah",240,13,16,8,40,48,23,4,10,17,14,113,4
"team",21900223,"GSW",1610612744,43,94,0.457,12,28,0.428571428571429,0.917,31,66,0.46969696969697,"Warriors","Golden State",240,11,12,6,31,37,28,11,3,8,18,109,-4
"team",21900224,"LAC",1610612746,45,87,0.517,13,33,0.393939393939394,0.792,32,54,0.592592592592593,"Clippers","LA",240,19,24,10,37,47,27,9,4,19,32,122,3
"team",21900224,"HOU",1610612745,39,84,0.464,15,43,0.348837209302326,0.684,24,41,0.585365853658537,"Rockets","Houston",240,26,38,11,32,43,22,11,2,15,27,119,-3
"team",21900225,"PHX",1610612756,33,96,0.344,10,35,0.285714285714286,0.923,23,61,0.377049180327869,"Suns","Phoenix",240,24,26,12,44,56,22,9,3,7,17,100,2
"team",21900225,"MIN",1610612750,38,91,0.418,12,42,0.285714285714286,0.588,26,49,0.530612244897959,"Timberwolves","Minnesota",240,10,17,9,48,57,26,2,10,14,23,98,-2
"team",21900226,"CHI",1610612741,43,95,0.453,22,47,0.468085106382979,0.667,21,48,0.4375,"Bulls","Chicago",240,8,12,13,26,39,27,12,3,13,20,116,1
"team",21900226,"CHA",1610612766,44,80,0.55,12,28,0.428571428571429,0.682,32,52,0.615384615384615,"Hornets","Charlotte",240,15,22,10,33,43,26,5,7,19,17,115,-1
"team",21900227,"ORL",1610612753,43,92,0.467,13,31,0.419354838709677,0.778,30,61,0.491803278688525,"Magic","Orlando",240,7,9,7,26,33,24,11,5,13,16,106,-5
"team",21900227,"IND",1610612754,43,79,0.544,10,24,0.416666666666667,0.938,33,55,0.6,"Pacers","Indiana",240,15,16,7,35,42,26,6,6,19,14,111,5
"team",21900228,"TOR",1610612761,40,88,0.455,13,37,0.351351351351351,0.867,27,51,0.529411764705882,"Raptors","Toronto",240,26,30,12,30,42,22,5,5,15,16,119,3
"team",21900228,"ATL",1610612737,47,90,0.522,14,34,0.411764705882353,0.727,33,56,0.589285714285714,"Hawks","Atlanta",240,8,11,8,30,38,32,9,7,15,27,116,-3
"team",21900229,"SAS",1610612759,40,75,0.533,12,23,0.521739130434783,0.679,28,52,0.538461538461538,"Spurs","San Antonio",240,19,28,9,38,47,26,7,3,22,17,111,7
"team",21900229,"NYK",1610612752,40,93,0.43,15,40,0.375,0.6,25,53,0.471698113207547,"Knicks","New York",240,9,15,10,27,37,30,12,3,11,22,104,-7
"team",21900230,"PHI",1610612755,42,83,0.506,14,29,0.482758620689655,0.882,28,54,0.518518518518518,"76ers","Philadelphia",240,15,17,8,36,44,28,11,2,14,27,113,27
"team",21900230,"MIA",1610612748,30,75,0.4,6,24,0.25,0.741,24,51,0.470588235294118,"Heat","Miami",240,20,27,9,29,38,12,6,4,17,16,86,-27
"team",21900231,"POR",1610612757,39,87,0.448,14,40,0.35,0.75,25,47,0.531914893617021,"Trail Blazers","Portland",240,12,16,6,32,38,21,6,6,10,20,104,-6
"team",21900231,"CLE",1610612739,37,87,0.425,10,31,0.32258064516129,0.813,27,56,0.482142857142857,"Cavaliers","Cleveland",240,26,32,9,43,52,19,9,2,13,14,110,6
"team",21900232,"MEM",1610612763,43,89,0.483,14,30,0.466666666666667,0.615,29,59,0.491525423728814,"Grizzlies","Memphis",240,8,13,12,35,47,28,12,3,19,19,108,-1
"team",21900232,"LAL",1610612747,38,84,0.452,13,39,0.333333333333333,0.69,25,45,0.555555555555556,"Lakers","Los Angeles",240,20,29,11,29,40,19,12,7,16,14,109,1
"team",21900233,"MIL",1610612749,41,84,0.488,13,37,0.351351351351351,0.5,28,47,0.595744680851064,"Bucks","Milwaukee",240,9,18,9,40,49,25,10,8,21,14,104,14
"team",21900233,"DET",1610612765,37,91,0.407,10,35,0.285714285714286,0.6,27,56,0.482142857142857,"Pistons","Detroit",240,6,10,6,34,40,22,7,3,15,18,90,-14
"team",21900234,"UTA",1610612762,42,82,0.512,15,36,0.416666666666667,0.879,27,46,0.58695652173913,"Jazz","Utah",240,29,33,7,42,49,29,2,4,17,21,128,8
"team",21900234,"NOP",1610612740,42,101,0.416,17,41,0.414634146341463,0.95,25,60,0.416666666666667,"Pelicans","New Orleans",240,19,20,9,29,38,21,7,6,10,24,120,-8
"team",21900235,"HOU",1610612745,45,98,0.459,10,44,0.227272727272727,0.742,35,54,0.648148148148148,"Rockets","Houston",240,23,31,15,39,54,26,5,2,11,26,123,-14
"team",21900235,"DAL",1610612742,49,102,0.48,17,44,0.386363636363636,0.786,32,58,0.551724137931034,"Mavericks","Dallas",240,22,28,12,34,46,28,9,5,12,22,137,14
"team",21900236,"NYK",1610612752,37,80,0.463,18,35,0.514285714285714,0.563,19,45,0.422222222222222,"Knicks","New York",240,9,16,9,34,43,22,6,4,16,29,101,-2
"team",21900236,"BKN",1610612751,31,77,0.403,14,38,0.368421052631579,0.794,17,39,0.435897435897436,"Nets","Brooklyn",240,27,34,7,28,35,18,6,1,11,16,103,2
"team",21900237,"WAS",1610612764,42,92,0.457,13,34,0.382352941176471,0.75,29,58,0.5,"Wizards","Washington",240,9,12,12,33,45,29,5,2,16,23,106,-7
"team",21900237,"SAC",1610612758,39,81,0.481,11,31,0.354838709677419,0.857,28,50,0.56,"Kings","Sacramento",240,24,28,6,33,39,22,9,5,13,17,113,7
"team",21900238,"PHX",1610612756,41,82,0.5,12,35,0.342857142857143,0.833,29,47,0.617021276595745,"Suns","Phoenix",240,10,12,7,29,36,25,4,2,12,18,104,-12
"team",21900238,"DEN",1610612743,43,91,0.473,14,31,0.451612903225806,0.696,29,60,0.483333333333333,"Nuggets","Denver",240,16,23,19,33,52,24,4,2,10,16,116,12
"team",21900239,"NOP",1610612740,43,98,0.439,13,41,0.317073170731707,0.556,30,57,0.526315789473684,"Pelicans","New Orleans",240,10,18,12,33,45,26,1,6,9,26,109,-25
"team",21900239,"LAC",1610612746,46,98,0.469,16,43,0.372093023255814,0.788,30,55,0.545454545454545,"Clippers","LA",240,26,33,16,40,56,27,4,5,6,21,134,25
"team",21900240,"CLE",1610612739,40,94,0.426,13,32,0.40625,0.65,27,62,0.435483870967742,"Cavaliers","Cleveland",240,13,20,12,33,45,24,5,4,10,14,106,-2
"team",21900240,"BKN",1610612751,44,94,0.468,11,34,0.323529411764706,0.818,33,60,0.55,"Nets","Brooklyn",240,9,11,12,36,48,29,8,10,9,21,108,2
"team",21900241,"ORL",1610612753,32,84,0.381,8,25,0.32,0.727,24,59,0.406779661016949,"Magic","Orlando",240,16,22,8,33,41,15,8,7,9,21,88,-15
"team",21900241,"DET",1610612765,34,79,0.43,14,38,0.368421052631579,0.84,20,41,0.48780487804878,"Pistons","Detroit",240,21,25,9,40,49,23,6,5,13,20,103,15
"team",21900242,"MEM",1610612763,46,96,0.479,13,29,0.448275862068966,0.692,33,67,0.492537313432836,"Grizzlies","Memphis",240,9,13,8,32,40,30,6,5,8,16,114,-12
"team",21900242,"IND",1610612754,51,94,0.543,18,33,0.545454545454545,0.6,33,61,0.540983606557377,"Pacers","Indiana",240,6,10,10,37,47,29,6,6,13,11,126,12
"team",21900243,"MIN",1610612750,41,90,0.456,15,35,0.428571428571429,0.778,26,55,0.472727272727273,"Timberwolves","Minnesota",240,28,36,14,33,47,27,10,6,13,25,125,12
"team",21900243,"ATL",1610612737,41,94,0.436,10,32,0.3125,0.808,31,62,0.5,"Hawks","Atlanta",240,21,26,9,33,42,26,6,4,17,25,113,-12
"team",21900244,"SAC",1610612758,37,79,0.468,18,47,0.382978723404255,0.667,19,32,0.59375,"Kings","Sacramento",240,10,15,8,28,36,28,3,8,14,18,102,-1
"team",21900244,"BOS",1610612738,38,85,0.447,7,30,0.233333333333333,0.87,31,55,0.563636363636364,"Celtics","Boston",240,20,23,11,27,38,20,10,4,11,16,103,1
"team",21900245,"MIA",1610612748,40,77,0.519,13,31,0.419354838709677,0.857,27,46,0.58695652173913,"Heat","Miami",240,24,28,8,41,49,29,9,3,18,23,117,17
"team",21900245,"CHA",1610612766,36,87,0.414,9,33,0.272727272727273,0.76,27,54,0.5,"Hornets","Charlotte",240,19,25,10,25,35,25,11,0,13,24,100,-17
"team",21900246,"TOR",1610612761,38,84,0.452,11,34,0.323529411764706,0.636,27,50,0.54,"Raptors","Toronto",240,14,22,8,32,40,27,5,5,10,18,101,5
"team",21900246,"PHI",1610612755,36,88,0.409,15,40,0.375,0.563,21,48,0.4375,"76ers","Philadelphia",240,9,16,14,37,51,25,7,3,16,20,96,-5
"team",21900247,"POR",1610612757,46,89,0.517,8,27,0.296296296296296,0.773,38,62,0.612903225806452,"Trail Blazers","Portland",240,17,22,13,42,55,23,8,5,15,20,117,23
"team",21900247,"CHI",1610612741,36,86,0.419,9,39,0.230769230769231,0.65,27,47,0.574468085106383,"Bulls","Chicago",240,13,20,8,29,37,24,8,4,17,20,94,-23
"team",21900248,"UTA",1610612762,43,85,0.506,21,45,0.466666666666667,0.917,22,40,0.55,"Jazz","Utah",240,11,12,4,36,40,29,4,6,16,23,118,-4
"team",21900248,"MIL",1610612749,43,97,0.443,13,41,0.317073170731707,0.793,30,56,0.535714285714286,"Bucks","Milwaukee",240,23,29,15,34,49,21,6,6,9,15,122,4
"team",21900249,"SAS",1610612759,41,88,0.466,10,25,0.4,0.8,31,63,0.492063492063492,"Spurs","San Antonio",240,12,15,9,32,41,23,4,5,13,22,104,-10
"team",21900249,"LAL",1610612747,44,89,0.494,14,33,0.424242424242424,0.667,30,56,0.535714285714286,"Lakers","Los Angeles",240,12,18,10,30,40,28,7,6,9,18,114,10
"team",21900250,"OKC",1610612760,40,85,0.471,11,32,0.34375,0.818,29,53,0.547169811320755,"Thunder","Oklahoma City",240,9,11,9,34,43,26,5,13,15,16,100,3
"team",21900250,"GSW",1610612744,37,89,0.416,9,20,0.45,0.875,28,69,0.405797101449275,"Warriors","Golden State",240,14,16,9,32,41,27,10,7,12,17,97,-3
"team",21900251,"LAC",1610612746,41,97,0.423,11,33,0.333333333333333,0.7,30,64,0.46875,"Clippers","LA",240,21,30,17,39,56,22,12,3,14,27,114,15
"team",21900251,"DAL",1610612742,30,79,0.38,11,38,0.289473684210526,0.8,19,41,0.463414634146341,"Mavericks","Dallas",240,28,35,9,37,46,16,12,2,20,21,99,-15
"team",21900252,"WAS",1610612764,40,95,0.421,10,40,0.25,0.667,30,55,0.545454545454545,"Wizards","Washington",240,14,21,5,31,36,26,9,3,12,22,104,-13
"team",21900252,"DEN",1610612743,47,90,0.522,6,24,0.25,0.739,41,66,0.621212121212121,"Nuggets","Denver",240,17,23,10,48,58,31,8,6,20,20,117,13
"team",21900253,"BOS",1610612738,43,97,0.443,13,34,0.382352941176471,0.917,30,63,0.476190476190476,"Celtics","Boston",240,22,24,19,36,55,23,10,5,14,17,121,11
"team",21900253,"BKN",1610612751,40,90,0.444,21,56,0.375,0.474,19,34,0.558823529411765,"Nets","Brooklyn",240,9,19,11,27,38,32,5,6,15,22,110,-11
"team",21900254,"DET",1610612765,41,88,0.466,10,32,0.3125,0.6,31,56,0.553571428571429,"Pistons","Detroit",240,9,15,9,37,46,23,2,2,8,18,101,-1
"team",21900254,"CHA",1610612766,39,88,0.443,7,30,0.233333333333333,0.85,32,58,0.551724137931034,"Hornets","Charlotte",240,17,20,10,31,41,27,3,7,3,18,102,1
"team",21900255,"ORL",1610612753,45,93,0.484,12,33,0.363636363636364,0.824,33,60,0.55,"Magic","Orlando",240,14,17,6,28,34,23,13,6,11,22,116,12
"team",21900255,"CLE",1610612739,37,81,0.457,11,34,0.323529411764706,0.864,26,47,0.553191489361702,"Cavaliers","Cleveland",240,19,22,12,37,49,20,5,0,25,15,104,-12
"team",21900256,"UTA",1610612762,36,83,0.434,10,32,0.3125,0.8,26,51,0.509803921568627,"Jazz","Utah",240,20,25,10,30,40,19,7,2,16,21,102,-19
"team",21900256,"IND",1610612754,50,96,0.521,8,22,0.363636363636364,0.813,42,74,0.567567567567568,"Pacers","Indiana",240,13,16,11,31,42,23,8,4,12,19,121,19
"team",21900257,"SAC",1610612758,39,95,0.411,9,34,0.264705882352941,0.444,30,61,0.491803278688525,"Kings","Sacramento",240,4,9,8,34,42,22,9,3,11,19,91,-6
"team",21900257,"PHI",1610612755,36,77,0.468,5,26,0.192307692307692,0.833,31,51,0.607843137254902,"76ers","Philadelphia",240,20,24,7,42,49,20,8,10,17,12,97,6
"team",21900258,"TOR",1610612761,46,94,0.489,21,41,0.51219512195122,0.765,25,53,0.471698113207547,"Raptors","Toronto",240,13,17,17,35,52,26,6,4,12,18,126,28
"team",21900258,"NYK",1610612752,33,88,0.375,12,41,0.292682926829268,0.833,21,47,0.446808510638298,"Knicks","New York",240,20,24,15,30,45,19,6,4,18,17,98,-28
"team",21900259,"MIA",1610612748,37,80,0.463,14,37,0.378378378378378,0.741,23,43,0.534883720930233,"Heat","Miami",240,20,27,8,33,41,22,8,3,18,24,108,-9
"team",21900259,"HOU",1610612745,38,83,0.458,15,44,0.340909090909091,0.788,23,39,0.58974358974359,"Rockets","Houston",240,26,33,9,34,43,19,11,2,15,22,117,9
"team",21900260,"MEM",1610612763,43,92,0.467,11,28,0.392857142857143,0.846,32,64,0.5,"Grizzlies","Memphis",240,22,26,13,35,48,26,9,3,20,22,119,-2
"team",21900260,"LAC",1610612746,44,95,0.463,14,41,0.341463414634146,0.76,30,54,0.555555555555556,"Clippers","LA",240,19,25,13,30,43,30,11,6,15,24,121,2
"team",21900261,"MIL",1610612749,42,88,0.477,10,34,0.294117647058824,0.63,32,54,0.592592592592593,"Bucks","Milwaukee",240,17,27,10,37,47,25,6,11,14,23,111,9
"team",21900261,"ATL",1610612737,38,94,0.404,11,34,0.323529411764706,0.682,27,60,0.45,"Hawks","Atlanta",240,15,22,14,35,49,22,4,5,17,25,102,-9
"team",21900262,"SAS",1610612759,41,97,0.423,5,29,0.172413793103448,0.824,36,68,0.529411764705882,"Spurs","San Antonio",240,14,17,8,38,46,25,4,8,6,18,101,-12
"team",21900262,"MIN",1610612750,37,85,0.435,18,40,0.45,0.778,19,45,0.422222222222222,"Timberwolves","Minnesota",240,21,27,7,46,53,28,4,6,11,19,113,12
"team",21900263,"WAS",1610612764,51,89,0.573,19,35,0.542857142857143,0.95,32,54,0.592592592592593,"Wizards","Washington",240,19,20,4,30,34,32,9,5,14,20,140,8
"team",21900263,"PHX",1610612756,48,93,0.516,15,38,0.394736842105263,0.875,33,55,0.6,"Suns","Phoenix",240,21,24,12,28,40,29,7,6,15,21,132,-8
"team",21900264,"NOP",1610612740,34,84,0.405,17,40,0.425,0.833,17,44,0.386363636363636,"Pelicans","New Orleans",240,25,30,13,29,42,20,7,4,19,23,110,-4
"team",21900264,"LAL",1610612747,44,85,0.518,8,24,0.333333333333333,0.72,36,61,0.590163934426229,"Lakers","Los Angeles",240,18,25,7,30,37,25,9,6,15,24,114,4
"team",21900265,"POR",1610612757,49,94,0.521,14,30,0.466666666666667,1,35,64,0.546875,"Trail Blazers","Portland",240,24,24,10,44,54,23,3,1,9,32,136,17
"team",21900265,"OKC",1610612760,39,88,0.443,11,35,0.314285714285714,0.789,28,53,0.528301886792453,"Thunder","Oklahoma City",240,30,38,8,30,38,19,4,2,6,21,119,-17
"team",21900266,"GSW",1610612744,37,81,0.457,11,29,0.379310344827586,0.731,26,52,0.5,"Warriors","Golden State",240,19,26,13,41,54,31,12,9,20,17,104,14
"team",21900266,"CHI",1610612741,34,89,0.382,10,29,0.344827586206897,0.667,24,60,0.4,"Bulls","Chicago",240,12,18,14,28,42,20,14,4,17,20,90,-14
"team",21900267,"BOS",1610612738,41,93,0.441,9,28,0.321428571428571,0.762,32,65,0.492307692307692,"Celtics","Boston",240,16,21,16,32,48,16,11,7,19,14,107,-5
"team",21900267,"BKN",1610612751,43,93,0.462,17,41,0.414634146341463,0.692,26,52,0.5,"Nets","Brooklyn",240,9,13,13,36,49,30,9,6,18,24,112,5
"team",21900268,"DET",1610612765,41,83,0.494,15,35,0.428571428571429,0.5,26,48,0.541666666666667,"Pistons","Detroit",240,10,20,14,31,45,27,5,4,13,16,107,-3
"team",21900268,"CHA",1610612766,40,83,0.482,19,38,0.5,0.733,21,45,0.466666666666667,"Hornets","Charlotte",240,11,15,11,26,37,26,8,6,10,17,110,3
"team",21900269,"TOR",1610612761,31,84,0.369,11,38,0.289473684210526,0.607,20,46,0.434782608695652,"Raptors","Toronto",240,17,28,11,35,46,21,16,4,13,20,90,7
"team",21900269,"ORL",1610612753,27,78,0.346,7,29,0.241379310344828,0.815,20,49,0.408163265306122,"Magic","Orlando",240,22,27,13,39,52,17,10,11,22,19,83,-7
"team",21900270,"MIL",1610612749,45,88,0.511,12,34,0.352941176470588,0.739,33,54,0.611111111111111,"Bucks","Milwaukee",240,17,23,11,36,47,28,7,4,13,15,119,9
"team",21900270,"CLE",1610612739,44,88,0.5,17,34,0.5,0.5,27,54,0.5,"Cavaliers","Cleveland",240,5,10,8,33,41,32,7,1,14,22,110,-9
"team",21900271,"PHI",1610612755,31,72,0.431,7,26,0.269230769230769,0.8,24,46,0.521739130434783,"76ers","Philadelphia",240,32,40,8,38,46,22,5,10,16,23,101,6
"team",21900271,"NYK",1610612752,34,78,0.436,8,20,0.4,0.576,26,58,0.448275862068966,"Knicks","New York",240,19,33,9,28,37,14,5,4,14,33,95,-6
"team",21900272,"IND",1610612754,39,92,0.424,6,26,0.230769230769231,0.75,33,66,0.5,"Pacers","Indiana",265,21,28,9,33,42,19,12,6,15,20,105,1
"team",21900272,"ATL",1610612737,39,90,0.433,9,32,0.28125,0.944,30,58,0.517241379310345,"Hawks","Atlanta",265,17,18,10,38,48,14,10,3,24,27,104,-1
"team",21900273,"MIA",1610612748,44,82,0.537,13,25,0.52,0.75,31,57,0.543859649122807,"Heat","Miami",240,21,28,10,39,49,23,7,3,15,30,122,17
"team",21900273,"GSW",1610612744,30,77,0.39,10,28,0.357142857142857,0.875,20,49,0.408163265306122,"Warriors","Golden State",240,35,40,5,26,31,19,4,3,9,23,105,-17
"team",21900274,"UTA",1610612762,38,95,0.4,12,35,0.342857142857143,0.789,26,60,0.433333333333333,"Jazz","Utah",240,15,19,11,41,52,18,8,2,5,15,103,9
"team",21900274,"MEM",1610612763,37,94,0.394,10,34,0.294117647058824,0.588,27,60,0.45,"Grizzlies","Memphis",240,10,17,15,40,55,22,1,8,11,17,94,-9
"team",21900275,"OKC",1610612760,43,90,0.478,13,34,0.382352941176471,0.625,30,56,0.535714285714286,"Thunder","Oklahoma City",240,10,16,6,36,42,27,6,8,11,17,109,5
"team",21900275,"NOP",1610612740,39,87,0.448,11,38,0.289473684210526,0.714,28,49,0.571428571428571,"Pelicans","New Orleans",240,15,21,7,37,44,19,8,3,13,12,104,-5
"team",21900276,"SAS",1610612759,40,93,0.43,14,36,0.388888888888889,0.929,26,57,0.456140350877193,"Spurs","San Antonio",240,13,14,8,40,48,28,8,8,9,15,107,10
"team",21900276,"LAC",1610612746,36,92,0.391,12,33,0.363636363636364,1,24,59,0.406779661016949,"Clippers","LA",240,13,13,9,39,48,23,6,5,14,17,97,-10
"team",21900277,"PHX",1610612756,41,93,0.441,13,38,0.342105263157895,0.72,28,55,0.509090909090909,"Suns","Phoenix",240,18,25,11,36,47,29,3,3,10,29,113,-7
"team",21900277,"DAL",1610612742,35,85,0.412,17,47,0.361702127659574,0.868,18,38,0.473684210526316,"Mavericks","Dallas",240,33,38,9,38,47,20,7,3,8,24,120,7
"team",21900278,"POR",1610612757,38,84,0.452,10,30,0.333333333333333,0.75,28,54,0.518518518518518,"Trail Blazers","Portland",240,21,28,8,41,49,20,6,11,13,21,107,4
"team",21900278,"CHI",1610612741,36,94,0.383,14,38,0.368421052631579,0.68,22,56,0.392857142857143,"Bulls","Chicago",240,17,25,11,36,47,24,8,2,11,22,103,-4
"team",21900279,"WAS",1610612764,38,96,0.396,10,37,0.27027027027027,0.895,28,59,0.474576271186441,"Wizards","Washington",240,17,19,13,32,45,25,10,2,17,23,103,-22
"team",21900279,"LAL",1610612747,45,87,0.517,14,32,0.4375,0.75,31,55,0.563636363636364,"Lakers","Los Angeles",240,21,28,7,40,47,29,9,8,18,20,125,22
"team",21900280,"SAC",1610612758,37,96,0.385,8,33,0.242424242424242,0.857,29,63,0.46031746031746,"Kings","Sacramento",265,18,21,13,37,50,22,12,4,14,23,100,3
"team",21900280,"DEN",1610612743,36,87,0.414,11,32,0.34375,0.667,25,55,0.454545454545455,"Nuggets","Denver",265,14,21,9,39,48,23,11,5,16,21,97,-3
"team",21900281,"PHI",1610612755,38,77,0.494,11,23,0.478260869565217,0.889,27,54,0.5,"76ers","Philadelphia",240,32,36,4,28,32,27,12,5,12,16,119,3
"team",21900281,"IND",1610612754,42,76,0.553,11,22,0.5,0.84,31,54,0.574074074074074,"Pacers","Indiana",240,21,25,3,28,31,22,7,3,19,24,116,-3
"team",21900282,"HOU",1610612745,52,89,0.584,25,51,0.490196078431373,0.853,27,38,0.710526315789474,"Rockets","Houston",240,29,34,13,39,52,30,9,2,15,23,158,47
"team",21900282,"ATL",1610612737,38,89,0.427,15,46,0.326086956521739,0.8,23,43,0.534883720930233,"Hawks","Atlanta",240,20,25,8,21,29,26,5,2,13,23,111,-47
"team",21900283,"MIL",1610612749,54,96,0.563,20,44,0.454545454545455,0.6,34,52,0.653846153846154,"Bucks","Milwaukee",240,9,15,7,46,53,41,7,3,7,13,137,41
"team",21900283,"CHA",1610612766,37,101,0.366,15,45,0.333333333333333,0.875,22,56,0.392857142857143,"Hornets","Charlotte",240,7,8,15,38,53,21,4,1,12,18,96,-41
"team",21900284,"MIA",1610612748,37,95,0.389,12,37,0.324324324324324,0.821,25,58,0.431034482758621,"Heat","Miami",240,23,28,16,35,51,16,3,2,9,17,109,3
"team",21900284,"BKN",1610612751,40,91,0.44,14,42,0.333333333333333,0.75,26,49,0.530612244897959,"Nets","Brooklyn",240,12,16,9,39,48,24,3,5,12,21,106,-3
"team",21900285,"NYK",1610612752,35,76,0.461,8,26,0.307692307692308,0.703,27,50,0.54,"Knicks","New York",240,26,37,8,31,39,15,7,6,14,25,104,-9
"team",21900285,"BOS",1610612738,41,93,0.441,15,41,0.365853658536585,0.727,26,52,0.5,"Celtics","Boston",240,16,22,16,28,44,25,5,7,13,28,113,9
"team",21900286,"MIN",1610612750,33,85,0.388,11,36,0.305555555555556,0.857,22,49,0.448979591836735,"Timberwolves","Minnesota",240,30,35,10,43,53,22,7,6,16,21,107,-8
"team",21900286,"MEM",1610612763,41,100,0.41,16,40,0.4,0.81,25,60,0.416666666666667,"Grizzlies","Memphis",240,17,21,12,38,50,27,8,3,11,26,115,8
"team",21900287,"LAL",1610612747,40,87,0.46,7,27,0.259259259259259,0.813,33,60,0.55,"Lakers","Los Angeles",240,13,16,9,36,45,25,9,3,17,14,100,-14
"team",21900287,"DAL",1610612742,42,97,0.433,17,49,0.346938775510204,0.722,25,48,0.520833333333333,"Mavericks","Dallas",240,13,18,16,35,51,24,11,1,13,20,114,14
"team",21900288,"SAS",1610612759,36,88,0.409,7,26,0.269230769230769,0.864,29,62,0.467741935483871,"Spurs","San Antonio",240,19,22,7,24,31,20,11,6,8,15,98,-34
"team",21900288,"DET",1610612765,52,88,0.591,15,31,0.483870967741935,0.722,37,57,0.649122807017544,"Pistons","Detroit",240,13,18,11,39,50,33,5,5,15,14,132,34
"team",21900289,"OKC",1610612760,38,81,0.469,11,33,0.333333333333333,0.769,27,48,0.5625,"Thunder","Oklahoma City",240,20,26,5,42,47,19,5,3,11,14,107,3
"team",21900289,"NOP",1610612740,39,87,0.448,17,38,0.447368421052632,0.9,22,49,0.448979591836735,"Pelicans","New Orleans",240,9,10,3,38,41,22,6,7,11,22,104,-3
"team",21900290,"ORL",1610612753,37,87,0.425,11,33,0.333333333333333,0.682,26,54,0.481481481481481,"Magic","Orlando",240,15,22,12,36,48,21,7,8,12,20,100,4
"team",21900290,"GSW",1610612744,36,91,0.396,6,23,0.260869565217391,0.783,30,68,0.441176470588235,"Warriors","Golden State",240,18,23,15,31,46,21,6,5,10,17,96,-4
"team",21900291,"UTA",1610612762,38,90,0.422,13,35,0.371428571428571,0.724,25,55,0.454545454545455,"Jazz","Utah",240,21,29,15,36,51,21,5,3,18,17,110,-20
"team",21900291,"TOR",1610612761,47,90,0.522,19,36,0.527777777777778,0.81,28,54,0.518518518518518,"Raptors","Toronto",240,17,21,7,36,43,36,14,8,14,24,130,20
"team",21900292,"WAS",1610612764,47,102,0.461,11,30,0.366666666666667,0.741,36,72,0.5,"Wizards","Washington",240,20,27,12,31,43,32,10,1,14,29,125,-25
"team",21900292,"LAC",1610612746,52,94,0.553,14,32,0.4375,0.8,38,62,0.612903225806452,"Clippers","LA",240,32,40,10,42,52,22,8,5,16,25,150,25
"team",21900293,"PHX",1610612756,39,88,0.443,9,42,0.214285714285714,0.733,30,46,0.652173913043478,"Suns","Phoenix",240,22,30,9,28,37,30,12,7,7,21,109,5
"team",21900293,"CHA",1610612766,38,84,0.452,7,25,0.28,0.808,31,59,0.525423728813559,"Hornets","Charlotte",240,21,26,14,39,53,27,4,7,19,23,104,-5
"team",21900294,"UTA",1610612762,38,81,0.469,5,22,0.227272727272727,0.65,33,59,0.559322033898305,"Jazz","Utah",240,13,20,5,37,42,23,6,8,19,26,94,-9
"team",21900294,"PHI",1610612755,37,91,0.407,13,26,0.5,0.696,24,65,0.369230769230769,"76ers","Philadelphia",240,16,23,8,39,47,24,12,3,14,22,103,9
"team",21900295,"GSW",1610612744,33,83,0.398,3,17,0.176470588235294,0.833,30,66,0.454545454545455,"Warriors","Golden State",240,10,12,18,28,46,17,11,8,23,20,79,-25
"team",21900295,"ATL",1610612737,41,89,0.461,8,29,0.275862068965517,0.933,33,60,0.55,"Hawks","Atlanta",240,14,15,11,27,38,21,13,4,14,12,104,25
"team",21900296,"MEM",1610612763,38,89,0.427,10,38,0.263157894736842,0.947,28,51,0.549019607843137,"Grizzlies","Memphis",240,18,19,8,30,38,23,5,6,11,20,104,-13
"team",21900296,"IND",1610612754,44,88,0.5,16,38,0.421052631578947,0.867,28,50,0.56,"Pacers","Indiana",240,13,15,8,36,44,31,4,2,15,22,117,13
"team",21900297,"NYK",1610612752,28,91,0.308,10,39,0.256410256410256,0.667,18,52,0.346153846153846,"Knicks","New York",240,22,33,14,28,42,13,4,7,10,21,88,-44
"team",21900297,"MIL",1610612749,48,86,0.558,16,35,0.457142857142857,0.625,32,51,0.627450980392157,"Bucks","Milwaukee",240,20,32,10,47,57,30,7,4,13,23,132,44
"team",21900298,"SAC",1610612758,40,83,0.482,9,33,0.272727272727273,0.85,31,50,0.62,"Kings","Sacramento",240,17,20,10,31,41,22,7,5,18,26,106,-7
"team",21900298,"CHI",1610612741,36,75,0.48,16,37,0.432432432432432,0.862,20,38,0.526315789473684,"Bulls","Chicago",240,25,29,3,29,32,20,9,0,18,20,113,7
"team",21900299,"DET",1610612765,51,94,0.543,18,35,0.514285714285714,0.636,33,59,0.559322033898305,"Pistons","Detroit",240,7,11,10,36,46,33,11,7,10,16,127,33
"team",21900299,"CLE",1610612739,38,90,0.422,8,27,0.296296296296296,0.714,30,63,0.476190476190476,"Cavaliers","Cleveland",240,10,14,12,28,40,16,6,6,13,11,94,-33
"team",21900300,"WAS",1610612764,45,89,0.506,12,35,0.342857142857143,0.783,33,54,0.611111111111111,"Wizards","Washington",240,18,23,5,33,38,22,9,3,10,23,120,-7
"team",21900300,"ORL",1610612753,46,90,0.511,15,31,0.483870967741935,0.741,31,59,0.525423728813559,"Magic","Orlando",240,20,27,8,40,48,26,3,4,13,18,127,7
"team",21900301,"TOR",1610612761,35,91,0.385,11,43,0.255813953488372,0.806,24,48,0.5,"Raptors","Toronto",265,29,36,9,39,48,25,5,4,11,20,110,-11
"team",21900301,"MIA",1610612748,45,99,0.455,15,38,0.394736842105263,0.762,30,61,0.491803278688525,"Heat","Miami",265,16,21,10,45,55,29,4,7,11,27,121,11
"team",21900302,"NOP",1610612740,38,94,0.404,11,41,0.268292682926829,0.667,27,53,0.509433962264151,"Pelicans","New Orleans",240,10,15,9,38,47,20,4,4,11,19,97,-21
"team",21900302,"DAL",1610612742,38,88,0.432,19,45,0.422222222222222,0.852,19,43,0.441860465116279,"Mavericks","Dallas",240,23,27,10,41,51,22,5,8,10,14,118,21
"team",21900303,"SAS",1610612759,50,106,0.472,13,30,0.433333333333333,0.688,37,76,0.486842105263158,"Spurs","San Antonio",290,22,32,12,44,56,35,10,8,20,27,135,2
"team",21900303,"HOU",1610612745,42,111,0.378,15,51,0.294117647058824,0.944,27,60,0.45,"Rockets","Houston",290,34,36,18,42,60,22,11,7,17,30,133,-2
"team",21900304,"LAL",1610612747,39,84,0.464,7,24,0.291666666666667,0.667,32,60,0.533333333333333,"Lakers","Los Angeles",240,20,30,14,42,56,24,8,5,16,23,105,9
"team",21900304,"DEN",1610612743,37,91,0.407,6,29,0.206896551724138,0.941,31,62,0.5,"Nuggets","Denver",240,16,17,7,28,35,26,9,4,11,25,96,-9
"team",21900305,"POR",1610612757,39,91,0.429,7,27,0.259259259259259,0.8,32,64,0.5,"Trail Blazers","Portland",240,12,15,12,37,49,20,5,6,13,23,97,-20
"team",21900305,"LAC",1610612746,43,94,0.457,17,34,0.5,0.56,26,60,0.433333333333333,"Clippers","LA",240,14,25,11,38,49,25,7,3,10,15,117,20
"team",21900306,"GSW",1610612744,36,78,0.462,9,23,0.391304347826087,0.667,27,55,0.490909090909091,"Warriors","Golden State",240,10,15,6,31,37,18,7,3,16,12,91,-15
"team",21900306,"CHA",1610612766,40,87,0.46,21,48,0.4375,0.625,19,39,0.487179487179487,"Hornets","Charlotte",240,5,8,11,33,44,30,11,7,13,20,106,15
"team",21900307,"MIL",1610612749,44,90,0.489,14,35,0.4,0.926,30,55,0.545454545454545,"Bucks","Milwaukee",240,25,27,10,45,55,25,7,8,14,18,127,24
"team",21900307,"DET",1610612765,39,93,0.419,11,36,0.305555555555556,0.636,28,57,0.491228070175439,"Pistons","Detroit",240,14,22,9,31,40,25,5,3,11,19,103,-24
"team",21900308,"PHX",1610612756,43,88,0.489,15,33,0.454545454545455,0.65,28,55,0.509090909090909,"Suns","Phoenix",240,13,20,8,21,29,36,10,0,13,20,114,-14
"team",21900308,"ORL",1610612753,49,85,0.576,14,25,0.56,0.8,35,60,0.583333333333333,"Magic","Orlando",240,16,20,11,34,45,27,9,7,19,19,128,14
"team",21900309,"BKN",1610612751,50,101,0.495,14,31,0.451612903225806,0.889,36,70,0.514285714285714,"Nets","Brooklyn",240,16,18,18,35,53,26,8,6,15,20,130,12
"team",21900309,"ATL",1610612737,48,90,0.533,9,26,0.346153846153846,0.619,39,64,0.609375,"Hawks","Atlanta",240,13,21,9,26,35,24,8,9,16,19,118,-12
"team",21900310,"MIA",1610612748,34,77,0.442,14,38,0.368421052631579,0.647,20,39,0.512820512820513,"Heat","Miami",240,11,17,8,32,40,20,7,2,18,25,93,-19
"team",21900310,"BOS",1610612738,35,79,0.443,16,41,0.390243902439024,0.813,19,38,0.5,"Celtics","Boston",240,26,32,10,36,46,21,8,8,10,20,112,19
"team",21900311,"MEM",1610612763,37,96,0.385,7,30,0.233333333333333,0.857,30,66,0.454545454545455,"Grizzlies","Memphis",240,18,21,11,35,46,24,14,6,12,28,99,-7
"team",21900311,"CHI",1610612741,33,77,0.429,13,33,0.393939393939394,0.73,20,44,0.454545454545455,"Bulls","Chicago",240,27,37,10,40,50,22,5,13,20,22,106,7
"team",21900312,"OKC",1610612760,41,84,0.488,9,26,0.346153846153846,0.9,32,58,0.551724137931034,"Thunder","Oklahoma City",240,9,10,8,29,37,25,3,5,11,19,100,-7
"team",21900312,"IND",1610612754,42,87,0.483,9,24,0.375,0.824,33,63,0.523809523809524,"Pacers","Indiana",240,14,17,11,28,39,19,5,1,8,21,107,7
"team",21900313,"MIN",1610612750,37,89,0.416,17,38,0.447368421052632,0.885,20,51,0.392156862745098,"Timberwolves","Minnesota",240,23,26,15,29,44,23,5,7,12,21,114,-7
"team",21900313,"DAL",1610612742,46,92,0.5,11,37,0.297297297297297,0.783,35,55,0.636363636363636,"Mavericks","Dallas",240,18,23,13,32,45,24,5,5,8,16,121,7
"team",21900314,"UTA",1610612762,34,83,0.41,14,31,0.451612903225806,0.737,20,52,0.384615384615385,"Jazz","Utah",240,14,19,8,32,40,20,3,3,18,24,96,-25
"team",21900314,"LAL",1610612747,46,90,0.511,14,29,0.482758620689655,0.6,32,61,0.524590163934426,"Lakers","Los Angeles",240,15,25,8,38,46,27,13,12,7,17,121,25
"team",21900315,"SAC",1610612758,44,95,0.463,11,34,0.323529411764706,0.739,33,61,0.540983606557377,"Kings","Sacramento",240,17,23,13,31,44,26,7,7,10,17,116,-11
"team",21900315,"POR",1610612757,47,84,0.56,16,32,0.5,0.81,31,52,0.596153846153846,"Trail Blazers","Portland",240,17,21,6,37,43,28,6,10,12,18,127,11
"team",21900316,"WAS",1610612764,41,90,0.456,11,27,0.407407407407407,0.813,30,63,0.476190476190476,"Wizards","Washington",240,26,32,13,28,41,25,9,1,11,20,119,6
"team",21900316,"PHI",1610612755,41,77,0.532,13,28,0.464285714285714,0.75,28,49,0.571428571428571,"76ers","Philadelphia",240,18,24,8,36,44,25,7,6,21,24,113,-6
"team",21900317,"NYK",1610612752,34,83,0.41,9,34,0.264705882352941,0.652,25,49,0.510204081632653,"Knicks","New York",240,15,23,5,28,33,23,9,7,14,16,92,-37
"team",21900317,"DEN",1610612743,49,87,0.563,21,39,0.538461538461538,0.556,28,48,0.583333333333333,"Nuggets","Denver",240,10,18,9,39,48,38,8,5,13,19,129,37
"team",21900318,"TOR",1610612761,38,88,0.432,12,39,0.307692307692308,0.875,26,49,0.530612244897959,"Raptors","Toronto",240,21,24,12,33,45,27,14,5,17,21,109,-10
"team",21900318,"HOU",1610612745,40,98,0.408,22,55,0.4,0.895,18,43,0.418604651162791,"Rockets","Houston",240,17,19,20,34,54,29,11,2,22,24,119,10
"team",21900319,"PHX",1610612756,50,106,0.472,14,36,0.388888888888889,0.926,36,70,0.514285714285714,"Suns","Phoenix",265,25,27,19,32,51,30,16,6,18,29,139,7
"team",21900319,"NOP",1610612740,44,87,0.506,17,41,0.414634146341463,0.771,27,46,0.58695652173913,"Pelicans","New Orleans",265,27,35,6,34,40,27,13,9,23,29,132,-7
"team",21900320,"CHA",1610612766,36,83,0.434,17,40,0.425,0.882,19,43,0.441860465116279,"Hornets","Charlotte",240,15,17,10,24,34,23,6,6,19,16,104,-7
"team",21900320,"BKN",1610612751,42,88,0.477,15,38,0.394736842105263,0.8,27,50,0.54,"Nets","Brooklyn",240,12,15,15,34,49,35,12,5,16,21,111,7
"team",21900321,"ORL",1610612753,32,82,0.39,9,26,0.346153846153846,0.87,23,56,0.410714285714286,"Magic","Orlando",240,20,23,10,33,43,19,10,9,17,13,93,6
"team",21900321,"CLE",1610612739,35,83,0.422,10,34,0.294117647058824,0.7,25,49,0.510204081632653,"Cavaliers","Cleveland",240,7,10,10,35,45,22,9,7,16,19,87,-6
"team",21900322,"IND",1610612754,38,83,0.458,9,24,0.375,0.8,29,59,0.491525423728814,"Pacers","Indiana",240,16,20,5,28,33,24,8,9,11,18,101,-7
"team",21900322,"DET",1610612765,39,87,0.448,11,25,0.44,0.731,28,62,0.451612903225806,"Pistons","Detroit",240,19,26,14,37,51,21,7,5,17,17,108,7
"team",21900323,"DEN",1610612743,39,94,0.415,5,30,0.166666666666667,0.8,34,64,0.53125,"Nuggets","Denver",240,12,15,12,29,41,18,5,4,12,15,95,-13
"team",21900323,"BOS",1610612738,44,82,0.537,13,35,0.371428571428571,0.875,31,47,0.659574468085106,"Celtics","Boston",240,7,8,4,33,37,21,5,5,15,23,108,13
"team",21900324,"WAS",1610612764,39,91,0.429,12,39,0.307692307692308,0.929,27,52,0.519230769230769,"Wizards","Washington",240,13,14,9,30,39,29,6,4,11,20,103,-9
"team",21900324,"MIA",1610612748,42,86,0.488,10,28,0.357142857142857,0.75,32,58,0.551724137931034,"Heat","Miami",240,18,24,11,39,50,28,6,7,12,13,112,9
"team",21900325,"GSW",1610612744,38,71,0.535,9,24,0.375,0.682,29,47,0.617021276595745,"Warriors","Golden State",240,15,22,6,33,39,24,9,4,19,19,100,2
"team",21900325,"CHI",1610612741,39,88,0.443,17,41,0.414634146341463,0.6,22,47,0.468085106382979,"Bulls","Chicago",240,3,5,10,27,37,21,11,2,14,20,98,-2
"team",21900326,"OKC",1610612760,49,88,0.557,5,18,0.277777777777778,0.9,44,70,0.628571428571429,"Thunder","Oklahoma City",265,36,40,9,30,39,19,8,9,10,20,139,12
"team",21900326,"MIN",1610612750,50,96,0.521,13,38,0.342105263157895,0.7,37,58,0.637931034482759,"Timberwolves","Minnesota",265,14,20,10,26,36,25,8,2,13,29,127,-12
"team",21900327,"MIL",1610612749,44,94,0.468,14,36,0.388888888888889,0.81,30,58,0.517241379310345,"Bucks","Milwaukee",240,17,21,13,40,53,29,11,6,15,23,119,28
"team",21900327,"LAC",1610612746,33,94,0.351,8,32,0.25,0.895,25,62,0.403225806451613,"Clippers","LA",240,17,19,12,36,48,18,9,4,21,19,91,-28
"team",21900328,"SAS",1610612759,41,96,0.427,11,32,0.34375,0.706,30,64,0.46875,"Spurs","San Antonio",265,12,17,13,39,52,25,10,5,17,16,105,1
"team",21900328,"SAC",1610612758,40,102,0.392,9,34,0.264705882352941,0.833,31,68,0.455882352941176,"Kings","Sacramento",265,15,18,16,36,52,19,10,3,14,20,104,-1
"team",21900329,"POR",1610612757,39,86,0.453,10,34,0.294117647058824,0.862,29,52,0.557692307692308,"Trail Blazers","Portland",240,25,29,4,30,34,20,9,4,15,25,113,-23
"team",21900329,"LAL",1610612747,46,85,0.541,17,36,0.472222222222222,0.818,29,49,0.591836734693878,"Lakers","Los Angeles",240,27,33,3,42,45,26,10,8,16,23,136,23
"team",21900330,"NOP",1610612740,32,89,0.36,3,32,0.09375,0.81,29,57,0.508771929824561,"Pelicans","New Orleans",240,17,21,8,26,34,17,4,2,14,23,84,-46
"team",21900330,"DAL",1610612742,46,86,0.535,13,38,0.342105263157895,0.806,33,48,0.6875,"Mavericks","Dallas",240,25,31,8,47,55,25,8,4,12,17,130,46
"team",21900331,"NYK",1610612752,39,96,0.406,10,31,0.32258064516129,0.714,29,65,0.446153846153846,"Knicks","New York",240,15,21,15,37,52,24,11,6,11,14,103,-1
"team",21900331,"IND",1610612754,41,85,0.482,12,28,0.428571428571429,0.769,29,57,0.508771929824561,"Pacers","Indiana",240,10,13,5,37,42,26,7,9,16,17,104,1
"team",21900332,"PHI",1610612755,57,90,0.633,11,26,0.423076923076923,0.696,46,64,0.71875,"76ers","Philadelphia",240,16,23,10,41,51,43,13,8,8,16,141,47
"team",21900332,"CLE",1610612739,36,96,0.375,9,35,0.257142857142857,0.765,27,61,0.442622950819672,"Cavaliers","Cleveland",240,13,17,11,24,35,20,4,0,17,17,94,-47
"team",21900333,"PHX",1610612756,40,96,0.417,11,35,0.314285714285714,0.643,29,61,0.475409836065574,"Suns","Phoenix",240,18,28,13,38,51,29,4,3,15,25,109,-6
"team",21900333,"HOU",1610612745,41,91,0.451,11,40,0.275,0.733,30,51,0.588235294117647,"Rockets","Houston",240,22,30,10,41,51,21,10,7,15,28,115,6
"team",21900334,"UTA",1610612762,45,80,0.563,19,34,0.558823529411765,0.944,26,46,0.565217391304348,"Jazz","Utah",240,17,18,9,32,41,32,8,0,22,25,126,14
"team",21900334,"MEM",1610612763,43,81,0.531,10,35,0.285714285714286,0.64,33,46,0.717391304347826,"Grizzlies","Memphis",240,16,25,5,23,28,23,15,3,14,19,112,-14
"team",21900335,"DEN",1610612743,36,89,0.404,18,42,0.428571428571429,0.857,18,47,0.382978723404255,"Nuggets","Denver",240,12,14,7,30,37,25,4,5,12,23,102,-3
"team",21900335,"BKN",1610612751,40,87,0.46,7,28,0.25,0.783,33,59,0.559322033898305,"Nets","Brooklyn",240,18,23,10,38,48,25,5,1,11,15,105,3
"team",21900336,"CHA",1610612766,36,90,0.4,11,31,0.354838709677419,0.828,25,59,0.423728813559322,"Hornets","Charlotte",240,24,29,13,31,44,22,8,3,11,17,107,-15
"team",21900336,"ATL",1610612737,44,91,0.484,18,45,0.4,0.941,26,46,0.565217391304348,"Hawks","Atlanta",240,16,17,11,37,48,28,8,8,13,24,122,15
"team",21900337,"MIA",1610612748,32,77,0.416,11,35,0.314285714285714,0.795,21,42,0.5,"Heat","Miami",265,35,44,10,33,43,20,9,2,17,23,110,5
"team",21900337,"CHI",1610612741,35,80,0.438,13,36,0.361111111111111,0.815,22,44,0.5,"Bulls","Chicago",265,22,27,6,33,39,20,8,1,14,31,105,-5
"team",21900338,"TOR",1610612761,38,88,0.432,11,33,0.333333333333333,0.85,27,55,0.490909090909091,"Raptors","Toronto",240,17,20,13,29,42,21,13,4,18,22,104,-6
"team",21900338,"PHI",1610612755,40,79,0.506,14,32,0.4375,0.762,26,47,0.553191489361702,"76ers","Philadelphia",240,16,21,6,34,40,31,7,5,18,18,110,6
"team",21900339,"WAS",1610612764,40,88,0.455,14,33,0.424242424242424,0.833,26,55,0.472727272727273,"Wizards","Washington",240,25,30,8,30,38,28,5,3,13,22,119,-16
"team",21900339,"LAC",1610612746,50,96,0.521,15,40,0.375,0.741,35,56,0.625,"Clippers","LA",240,20,27,9,36,45,27,8,4,10,26,135,16
"team",21900340,"SAC",1610612758,44,85,0.518,13,34,0.382352941176471,0.818,31,51,0.607843137254902,"Kings","Sacramento",240,9,11,7,28,35,24,7,1,8,16,110,4
"team",21900340,"DAL",1610612742,41,86,0.477,17,44,0.386363636363636,0.875,24,42,0.571428571428571,"Mavericks","Dallas",240,7,8,10,30,40,24,3,1,12,11,106,-4
"team",21900341,"POR",1610612757,36,100,0.36,9,33,0.272727272727273,0.833,27,67,0.402985074626866,"Trail Blazers","Portland",240,15,18,18,33,51,16,7,8,8,26,96,-12
"team",21900341,"OKC",1610612760,35,85,0.412,11,32,0.34375,0.794,24,53,0.452830188679245,"Thunder","Oklahoma City",240,27,34,13,41,54,12,7,2,10,22,108,12
"team",21900342,"MIN",1610612750,44,84,0.524,15,37,0.405405405405405,0.846,29,47,0.617021276595745,"Timberwolves","Minnesota",240,22,26,6,25,31,27,5,6,15,18,125,-17
"team",21900342,"LAL",1610612747,55,94,0.585,14,31,0.451612903225806,0.9,41,63,0.650793650793651,"Lakers","Los Angeles",240,18,20,10,31,41,32,9,1,10,19,142,17
"team",21900343,"LAC",1610612746,40,97,0.412,10,32,0.3125,0.741,30,65,0.461538461538462,"Clippers","LA",240,20,27,12,45,57,19,7,7,11,16,110,11
"team",21900343,"IND",1610612754,34,97,0.351,10,35,0.285714285714286,0.75,24,62,0.387096774193548,"Pacers","Indiana",240,21,28,14,41,55,16,7,3,13,21,99,-11
"team",21900344,"CLE",1610612739,36,91,0.396,7,31,0.225806451612903,0.474,29,60,0.483333333333333,"Cavaliers","Cleveland",240,9,19,18,27,45,18,8,2,18,11,88,-22
"team",21900344,"BOS",1610612738,45,78,0.577,15,27,0.555555555555556,0.625,30,51,0.588235294117647,"Celtics","Boston",240,5,8,5,34,39,22,8,9,18,19,110,22
"team",21900345,"TOR",1610612761,34,90,0.378,7,29,0.241379310344828,0.692,27,61,0.442622950819672,"Raptors","Toronto",240,18,26,14,40,54,19,8,9,15,12,93,1
"team",21900345,"CHI",1610612741,35,89,0.393,12,46,0.260869565217391,0.714,23,43,0.534883720930233,"Bulls","Chicago",240,10,14,9,36,45,30,6,4,14,20,92,-1
"team",21900346,"SAC",1610612758,40,88,0.455,20,45,0.444444444444444,0.864,20,43,0.465116279069767,"Kings","Sacramento",240,19,22,9,28,37,24,14,5,9,17,119,1
"team",21900346,"HOU",1610612745,41,84,0.488,17,50,0.34,0.826,24,34,0.705882352941177,"Rockets","Houston",240,19,23,11,40,51,25,4,6,19,20,118,-1
"team",21900347,"ORL",1610612753,35,92,0.38,10,31,0.32258064516129,0.808,25,61,0.409836065573771,"Magic","Orlando",240,21,26,9,35,44,24,8,10,12,18,101,-9
"team",21900347,"MIL",1610612749,43,92,0.467,16,41,0.390243902439024,0.533,27,51,0.529411764705882,"Bucks","Milwaukee",240,8,15,10,44,54,30,7,4,14,19,110,9
"team",21900348,"NOP",1610612740,40,91,0.44,8,38,0.210526315789474,0.682,32,53,0.60377358490566,"Pelicans","New Orleans",240,15,22,10,35,45,24,6,1,12,22,103,-2
"team",21900348,"DET",1610612765,36,85,0.424,11,35,0.314285714285714,0.815,25,50,0.5,"Pistons","Detroit",240,22,27,10,36,46,15,6,3,18,20,105,2
"team",21900349,"PHX",1610612756,47,95,0.495,16,40,0.4,0.789,31,55,0.563636363636364,"Suns","Phoenix",240,15,19,12,30,42,31,5,5,9,23,125,16
"team",21900349,"MIN",1610612750,40,85,0.471,6,22,0.272727272727273,0.793,34,63,0.53968253968254,"Timberwolves","Minnesota",240,23,29,11,34,45,14,6,7,16,23,109,-16
"team",21900350,"UTA",1610612762,36,89,0.404,8,31,0.258064516129032,0.833,28,58,0.482758620689655,"Jazz","Utah",240,10,12,7,41,48,19,7,0,14,16,90,-14
"team",21900350,"OKC",1610612760,40,85,0.471,8,28,0.285714285714286,0.842,32,57,0.56140350877193,"Thunder","Oklahoma City",240,16,19,2,44,46,21,9,7,10,20,104,14
"team",21900351,"MEM",1610612763,41,82,0.5,15,40,0.375,0.765,26,42,0.619047619047619,"Grizzlies","Memphis",240,13,17,1,41,42,29,13,6,18,20,110,8
"team",21900351,"GSW",1610612744,35,93,0.376,11,27,0.407407407407407,0.84,24,66,0.363636363636364,"Warriors","Golden State",240,21,25,10,36,46,23,10,6,15,21,102,-8
"team",21900352,"WAS",1610612764,38,90,0.422,11,35,0.314285714285714,0.8,27,55,0.490909090909091,"Wizards","Washington",240,20,25,13,32,45,27,7,7,10,24,107,-7
"team",21900352,"CHA",1610612766,38,85,0.447,16,41,0.390243902439024,0.786,22,44,0.5,"Hornets","Charlotte",240,22,28,11,37,48,22,4,4,13,26,114,7
"team",21900353,"PHI",1610612755,37,89,0.416,12,36,0.333333333333333,0.688,25,53,0.471698113207547,"76ers","Philadelphia",240,11,16,12,37,49,24,9,3,15,15,97,5
"team",21900353,"DEN",1610612743,37,85,0.435,7,27,0.259259259259259,0.917,30,58,0.517241379310345,"Nuggets","Denver",240,11,12,5,33,38,29,12,9,13,14,92,-5
"team",21900354,"MIA",1610612748,53,103,0.515,14,41,0.341463414634146,0.682,39,62,0.629032258064516,"Heat","Miami",265,15,22,9,44,53,35,5,3,11,17,135,14
"team",21900354,"ATL",1610612737,45,95,0.474,20,54,0.37037037037037,0.611,25,41,0.609756097560976,"Hawks","Atlanta",265,11,18,4,33,37,30,4,6,11,23,121,-14
"team",21900355,"POR",1610612757,39,90,0.433,17,41,0.414634146341463,0.833,22,49,0.448979591836735,"Trail Blazers","Portland",240,20,24,11,47,58,20,6,7,12,21,115,28
"team",21900355,"NYK",1610612752,32,91,0.352,7,38,0.184210526315789,0.615,25,53,0.471698113207547,"Knicks","New York",240,16,26,11,36,47,16,5,3,11,18,87,-28
"team",21900356,"HOU",1610612745,43,87,0.494,17,42,0.404761904761905,1,26,45,0.577777777777778,"Rockets","Houston",240,13,13,11,25,36,18,10,6,13,14,116,6
"team",21900356,"CLE",1610612739,46,89,0.517,13,32,0.40625,0.625,33,57,0.578947368421053,"Cavaliers","Cleveland",240,5,8,9,27,36,29,8,4,15,15,110,-6
"team",21900357,"IND",1610612754,41,85,0.482,10,25,0.4,0.833,31,60,0.516666666666667,"Pacers","Indiana",240,30,36,5,31,36,27,11,4,10,18,122,5
"team",21900357,"BOS",1610612738,43,87,0.494,14,36,0.388888888888889,0.773,29,51,0.568627450980392,"Celtics","Boston",240,17,22,8,36,44,25,6,4,15,27,117,-5
"team",21900358,"ORL",1610612753,34,81,0.42,8,26,0.307692307692308,0.647,26,55,0.472727272727273,"Magic","Orlando",240,11,17,8,33,41,20,10,5,14,17,87,-9
"team",21900358,"LAL",1610612747,37,87,0.425,12,31,0.387096774193548,0.526,25,56,0.446428571428571,"Lakers","Los Angeles",240,10,19,12,37,49,20,10,4,13,17,96,9
"team",21900359,"TOR",1610612761,31,88,0.352,8,36,0.222222222222222,0.88,23,52,0.442307692307692,"Raptors","Toronto",240,22,25,15,32,47,21,10,8,18,24,92,-20
"team",21900359,"LAC",1610612746,38,86,0.442,12,40,0.3,0.889,26,46,0.565217391304348,"Clippers","LA",240,24,27,12,38,50,29,8,5,18,21,112,20
"team",21900360,"CHA",1610612766,36,88,0.409,15,35,0.428571428571429,0.813,21,53,0.39622641509434,"Hornets","Charlotte",240,26,32,15,32,47,20,2,6,8,23,113,5
"team",21900360,"BKN",1610612751,38,88,0.432,10,38,0.263157894736842,0.667,28,50,0.56,"Nets","Brooklyn",240,22,33,17,35,52,20,5,3,12,21,108,-5
"team",21900361,"CHI",1610612741,54,94,0.574,11,24,0.458333333333333,0.895,43,70,0.614285714285714,"Bulls","Chicago",240,17,19,7,35,42,32,15,7,13,25,136,34
"team",21900361,"ATL",1610612737,35,83,0.422,13,38,0.342105263157895,0.731,22,45,0.488888888888889,"Hawks","Atlanta",240,19,26,10,31,41,26,7,5,23,20,102,-34
"team",21900362,"UTA",1610612762,47,83,0.566,16,35,0.457142857142857,0.773,31,48,0.645833333333333,"Jazz","Utah",240,17,22,11,34,45,23,4,7,15,22,127,11
"team",21900362,"MIN",1610612750,40,91,0.44,15,41,0.365853658536585,0.808,25,50,0.5,"Timberwolves","Minnesota",240,21,26,15,27,42,18,9,3,11,19,116,-11
"team",21900363,"PHX",1610612756,37,93,0.398,9,34,0.264705882352941,0.833,28,59,0.474576271186441,"Suns","Phoenix",240,25,30,8,36,44,29,6,4,12,20,108,-7
"team",21900363,"MEM",1610612763,42,87,0.483,10,24,0.416666666666667,0.808,32,63,0.507936507936508,"Grizzlies","Memphis",240,21,26,7,48,55,23,8,4,18,28,115,7
"team",21900364,"NOP",1610612740,39,88,0.443,16,45,0.355555555555556,0.818,23,43,0.534883720930233,"Pelicans","New Orleans",240,18,22,7,35,42,29,8,5,21,17,112,-15
"team",21900364,"MIL",1610612749,50,93,0.538,19,39,0.487179487179487,0.889,31,54,0.574074074074074,"Bucks","Milwaukee",240,8,9,5,38,43,27,13,2,14,17,127,15
"team",21900365,"SAC",1610612758,39,88,0.443,10,31,0.32258064516129,0.6,29,57,0.508771929824561,"Kings","Sacramento",240,6,10,6,35,41,12,8,3,15,21,94,1
"team",21900365,"OKC",1610612760,34,79,0.43,13,33,0.393939393939394,0.667,21,46,0.456521739130435,"Thunder","Oklahoma City",240,12,18,7,36,43,24,8,8,15,16,93,-1
"team",21900366,"NYK",1610612752,43,90,0.478,12,29,0.413793103448276,0.765,31,61,0.508196721311475,"Knicks","New York",265,26,34,12,46,58,25,5,7,18,24,124,2
"team",21900366,"GSW",1610612744,45,104,0.433,10,37,0.27027027027027,0.733,35,67,0.522388059701492,"Warriors","Golden State",265,22,30,14,32,46,27,10,6,8,25,122,-2
"team",21900367,"PHI",1610612755,41,82,0.5,14,28,0.5,0.826,27,54,0.5,"76ers","Philadelphia",240,19,23,8,37,45,27,4,8,11,19,115,6
"team",21900367,"BOS",1610612738,42,91,0.462,11,31,0.354838709677419,0.824,31,60,0.516666666666667,"Celtics","Boston",240,14,17,9,24,33,24,4,7,6,25,109,-6
"team",21900368,"SAS",1610612759,42,86,0.488,5,16,0.3125,0.8,37,70,0.528571428571429,"Spurs","San Antonio",265,20,25,2,34,36,19,11,7,12,21,109,-8
"team",21900368,"CLE",1610612739,44,96,0.458,15,45,0.333333333333333,0.7,29,51,0.568627450980392,"Cavaliers","Cleveland",265,14,20,11,39,50,22,6,3,18,22,117,8
"team",21900369,"DET",1610612765,40,89,0.449,15,42,0.357142857142857,0.696,25,47,0.531914893617021,"Pistons","Detroit",240,16,23,5,29,34,23,8,2,7,16,111,-11
"team",21900369,"DAL",1610612742,45,88,0.511,16,44,0.363636363636364,0.696,29,44,0.659090909090909,"Mavericks","Dallas",240,16,23,11,41,52,25,4,5,11,21,122,11
"team",21900370,"POR",1610612757,41,86,0.477,9,30,0.3,0.727,32,56,0.571428571428571,"Trail Blazers","Portland",240,8,11,7,28,35,22,4,7,8,16,99,-15
"team",21900370,"DEN",1610612743,42,88,0.477,18,36,0.5,0.632,24,52,0.461538461538462,"Nuggets","Denver",240,12,19,15,33,48,25,6,2,10,13,114,15
"team",21900371,"ORL",1610612753,40,91,0.44,15,37,0.405405405405405,0.75,25,54,0.462962962962963,"Magic","Orlando",240,12,16,13,24,37,24,3,6,6,15,107,-23
"team",21900371,"HOU",1610612745,48,86,0.558,22,39,0.564102564102564,0.923,26,47,0.553191489361702,"Rockets","Houston",240,12,13,7,35,42,21,5,7,9,20,130,23
"team",21900372,"PHI",1610612755,43,87,0.494,7,20,0.35,0.676,36,67,0.537313432835821,"76ers","Philadelphia",240,23,34,9,38,47,24,7,8,9,24,116,7
"team",21900372,"NOP",1610612740,38,88,0.432,9,24,0.375,0.686,29,64,0.453125,"Pelicans","New Orleans",240,24,35,12,33,45,24,5,2,9,29,109,-7
"team",21900374,"MIA",1610612748,39,85,0.459,10,33,0.303030303030303,0.786,29,52,0.557692307692308,"Heat","Miami",240,22,28,5,29,34,24,8,2,8,21,110,-3
"team",21900374,"LAL",1610612747,43,87,0.494,12,37,0.324324324324324,0.652,31,50,0.62,"Lakers","Los Angeles",240,15,23,14,36,50,26,5,9,19,23,113,3
"team",21900373,"IND",1610612754,46,92,0.5,7,22,0.318181818181818,0.733,39,70,0.557142857142857,"Pacers","Indiana",240,11,15,6,40,46,28,7,0,14,21,110,10
"team",21900373,"ATL",1610612737,39,94,0.415,6,28,0.214285714285714,0.696,33,66,0.5,"Hawks","Atlanta",240,16,23,12,38,50,24,6,4,15,20,100,-10
"team",21900375,"CHI",1610612741,27,90,0.3,7,34,0.205882352941176,0.857,20,56,0.357142857142857,"Bulls","Chicago",240,12,14,11,34,45,20,11,7,12,20,73,-10
"team",21900375,"CHA",1610612766,30,79,0.38,6,31,0.193548387096774,0.81,24,48,0.5,"Hornets","Charlotte",240,17,21,11,49,60,21,9,5,20,16,83,10
"team",21900376,"MIL",1610612749,44,87,0.506,11,30,0.366666666666667,0.848,33,57,0.578947368421053,"Bucks","Milwaukee",240,28,33,9,46,55,22,4,3,17,21,127,13
"team",21900376,"MEM",1610612763,38,98,0.388,20,49,0.408163265306122,0.783,18,49,0.36734693877551,"Grizzlies","Memphis",240,18,23,11,34,45,27,9,5,13,26,114,-13
"team",21900379,"UTA",1610612762,37,79,0.468,16,38,0.421052631578947,0.774,21,41,0.51219512195122,"Jazz","Utah",240,24,31,7,36,43,22,5,3,13,20,114,8
"team",21900379,"GSW",1610612744,41,91,0.451,9,29,0.310344827586207,0.682,32,62,0.516129032258065,"Warriors","Golden State",240,15,22,14,34,48,19,9,7,12,26,106,-8
"team",21900377,"MIN",1610612750,38,85,0.447,10,41,0.24390243902439,0.838,28,44,0.636363636363636,"Timberwolves","Minnesota",240,31,37,7,32,39,17,9,3,18,26,117,-7
"team",21900377,"LAC",1610612746,39,79,0.494,11,25,0.44,0.897,28,54,0.518518518518518,"Clippers","LA",240,35,39,8,37,45,16,5,2,19,30,124,7
"team",21900378,"SAC",1610612758,39,83,0.47,17,39,0.435897435897436,0.75,22,44,0.5,"Kings","Sacramento",240,6,8,8,33,41,19,0,3,13,18,101,-2
"team",21900378,"NYK",1610612752,44,95,0.463,9,30,0.3,0.6,35,65,0.538461538461538,"Knicks","New York",240,6,10,14,34,48,24,7,3,8,18,103,2
"team",21900380,"SAS",1610612759,44,106,0.415,8,30,0.266666666666667,0.735,36,76,0.473684210526316,"Spurs","San Antonio",265,25,34,10,52,62,23,6,9,11,22,121,2
"team",21900380,"PHX",1610612756,45,103,0.437,10,40,0.25,0.731,35,63,0.555555555555556,"Suns","Phoenix",265,19,26,6,53,59,29,5,5,10,24,119,-2
"team",21900381,"TOR",1610612761,38,98,0.388,14,40,0.35,0.8,24,58,0.413793103448276,"Raptors","Toronto",240,20,25,10,41,51,21,10,10,11,23,110,8
"team",21900381,"BKN",1610612751,39,101,0.386,12,46,0.260869565217391,0.706,27,55,0.490909090909091,"Nets","Brooklyn",240,12,17,13,46,59,24,4,7,20,20,102,-8
"team",21900382,"LAC",1610612746,35,80,0.438,10,22,0.454545454545455,0.722,25,58,0.431034482758621,"Clippers","LA",240,26,36,8,32,40,20,9,4,15,17,106,-3
"team",21900382,"CHI",1610612741,40,85,0.471,14,31,0.451612903225806,0.833,26,54,0.481481481481481,"Bulls","Chicago",240,15,18,12,38,50,21,12,9,17,25,109,3
"team",21900383,"WAS",1610612764,36,85,0.424,14,38,0.368421052631579,0.781,22,47,0.468085106382979,"Wizards","Washington",240,25,32,11,23,34,22,12,4,18,22,111,-17
"team",21900383,"MEM",1610612763,48,84,0.571,11,27,0.407407407407407,0.875,37,57,0.649122807017544,"Grizzlies","Memphis",240,21,24,9,37,46,32,11,7,23,24,128,17
"team",21900384,"MIA",1610612748,39,91,0.429,16,40,0.4,0.824,23,51,0.450980392156863,"Heat","Miami",265,28,34,5,44,49,27,8,3,8,18,122,4
"team",21900384,"DAL",1610612742,45,101,0.446,17,44,0.386363636363636,0.647,28,57,0.491228070175439,"Mavericks","Dallas",265,11,17,8,40,48,30,4,3,11,27,118,-4
"team",21900385,"MIL",1610612749,46,85,0.541,14,37,0.378378378378378,0.731,32,48,0.666666666666667,"Bucks","Milwaukee",240,19,26,8,33,41,26,12,6,12,17,125,17
"team",21900385,"CLE",1610612739,41,90,0.456,15,35,0.428571428571429,0.733,26,55,0.472727272727273,"Cavaliers","Cleveland",240,11,15,12,33,45,27,10,3,18,19,108,-17
"team",21900386,"HOU",1610612745,41,102,0.402,13,45,0.288888888888889,0.667,28,57,0.491228070175439,"Rockets","Houston",240,12,18,11,35,46,18,9,8,11,19,107,-8
"team",21900386,"DET",1610612765,41,92,0.446,12,37,0.324324324324324,0.84,29,55,0.527272727272727,"Pistons","Detroit",240,21,25,11,44,55,27,6,6,14,15,115,8
"team",21900387,"OKC",1610612760,38,81,0.469,6,23,0.260869565217391,0.87,32,58,0.551724137931034,"Thunder","Oklahoma City",240,20,23,7,30,37,22,7,3,15,23,102,-8
"team",21900387,"DEN",1610612743,43,85,0.506,7,27,0.259259259259259,0.739,36,58,0.620689655172414,"Nuggets","Denver",240,17,23,10,34,44,30,6,3,15,23,110,8
"team",21900388,"ORL",1610612753,46,89,0.517,17,34,0.5,0.808,29,55,0.527272727272727,"Magic","Orlando",240,21,26,8,31,39,32,8,2,9,15,130,11
"team",21900388,"NOP",1610612740,47,88,0.534,19,43,0.441860465116279,0.5,28,45,0.622222222222222,"Pelicans","New Orleans",240,6,12,11,29,40,34,6,7,17,21,119,-11
"team",21900389,"IND",1610612754,40,88,0.455,10,35,0.285714285714286,0.85,30,53,0.566037735849057,"Pacers","Indiana",240,17,20,8,43,51,30,6,9,9,25,107,22
"team",21900389,"CHA",1610612766,28,91,0.308,5,32,0.15625,0.686,23,59,0.389830508474576,"Hornets","Charlotte",240,24,35,17,39,56,18,4,5,10,21,85,-22
"team",21900390,"LAL",1610612747,36,84,0.429,5,31,0.161290322580645,0.727,31,53,0.584905660377358,"Lakers","Los Angeles",240,24,33,13,43,56,21,14,9,22,24,101,5
"team",21900390,"ATL",1610612737,31,86,0.36,12,42,0.285714285714286,0.88,19,44,0.431818181818182,"Hawks","Atlanta",240,22,25,8,34,42,18,8,5,19,27,96,-5
"team",21900391,"PHI",1610612755,37,86,0.43,5,26,0.192307692307692,0.588,32,60,0.533333333333333,"76ers","Philadelphia",240,10,17,7,31,38,19,9,13,16,20,89,-20
"team",21900391,"BKN",1610612751,43,94,0.457,9,24,0.375,0.778,34,70,0.485714285714286,"Nets","Brooklyn",240,14,18,12,39,51,22,9,1,16,23,109,20
"team",21900392,"NYK",1610612752,44,94,0.468,8,32,0.25,0.9,36,62,0.580645161290323,"Knicks","New York",240,9,10,14,33,47,20,9,2,11,19,105,-6
"team",21900392,"DEN",1610612743,44,94,0.468,10,28,0.357142857142857,0.684,34,66,0.515151515151515,"Nuggets","Denver",240,13,19,17,31,48,27,5,6,9,9,111,6
"team",21900393,"SAC",1610612758,38,63,0.603,10,22,0.454545454545455,0.875,28,41,0.682926829268293,"Kings","Sacramento",240,14,16,4,34,38,27,9,3,27,20,100,21
"team",21900393,"GSW",1610612744,30,76,0.395,6,25,0.24,0.722,24,51,0.470588235294118,"Warriors","Golden State",240,13,18,7,18,25,24,14,1,20,17,79,-21
"team",21900394,"WAS",1610612764,49,88,0.557,18,34,0.529411764705882,0.81,31,54,0.574074074074074,"Wizards","Washington",240,17,21,7,28,35,31,6,5,15,27,133,14
"team",21900394,"DET",1610612765,41,86,0.477,13,39,0.333333333333333,0.706,28,47,0.595744680851064,"Pistons","Detroit",240,24,34,12,24,36,29,6,4,14,19,119,-14
"team",21900395,"TOR",1610612761,52,89,0.584,16,32,0.5,0.765,36,57,0.631578947368421,"Raptors","Toronto",240,13,17,6,35,41,31,7,2,7,19,133,20
"team",21900395,"CLE",1610612739,44,90,0.489,12,35,0.342857142857143,0.765,32,55,0.581818181818182,"Cavaliers","Cleveland",240,13,17,9,30,39,30,6,1,10,15,113,-20
"team",21900396,"SAS",1610612759,39,91,0.429,12,33,0.363636363636364,0.85,27,58,0.46551724137931,"Spurs","San Antonio",240,17,20,8,45,53,23,5,4,18,22,107,-2
"team",21900396,"HOU",1610612745,40,98,0.408,11,43,0.255813953488372,0.667,29,55,0.527272727272727,"Rockets","Houston",240,18,27,14,44,58,20,9,6,12,19,109,2
"team",21900397,"MIA",1610612748,37,81,0.457,11,24,0.458333333333333,0.839,26,57,0.456140350877193,"Heat","Miami",240,26,31,7,28,35,22,9,7,14,26,111,-7
"team",21900397,"MEM",1610612763,42,86,0.488,13,36,0.361111111111111,0.7,29,50,0.58,"Grizzlies","Memphis",240,21,30,16,29,45,28,4,6,15,20,118,7
"team",21900398,"MIL",1610612749,44,105,0.419,11,41,0.268292682926829,0.708,33,64,0.515625,"Bucks","Milwaukee",240,17,24,15,37,52,29,8,4,8,23,116,-4
"team",21900398,"DAL",1610612742,41,88,0.466,16,41,0.390243902439024,0.815,25,47,0.531914893617021,"Mavericks","Dallas",240,22,27,8,44,52,27,5,6,14,23,120,4
"team",21900399,"OKC",1610612760,35,69,0.507,16,34,0.470588235294118,0.821,19,35,0.542857142857143,"Thunder","Oklahoma City",240,23,28,9,33,42,21,8,6,26,15,109,3
"team",21900399,"CHI",1610612741,43,87,0.494,9,31,0.290322580645161,0.846,34,56,0.607142857142857,"Bulls","Chicago",240,11,13,5,26,31,27,17,6,13,21,106,-3
"team",21900400,"POR",1610612757,40,84,0.476,14,34,0.411764705882353,0.85,26,50,0.52,"Trail Blazers","Portland",240,17,20,9,32,41,21,9,9,20,27,111,1
"team",21900400,"PHX",1610612756,41,90,0.456,12,34,0.352941176470588,0.842,29,56,0.517857142857143,"Suns","Phoenix",240,16,19,11,33,44,31,11,5,20,21,110,-1
"team",21900401,"SAC",1610612758,38,91,0.418,14,39,0.358974358974359,0.923,24,52,0.461538461538462,"Kings","Sacramento",240,12,13,10,23,33,23,10,5,10,22,102,-8
"team",21900401,"CHA",1610612766,39,81,0.481,13,30,0.433333333333333,0.704,26,51,0.509803921568627,"Hornets","Charlotte",240,19,27,16,35,51,26,5,8,16,18,110,8
"team",21900402,"LAL",1610612747,43,91,0.473,8,31,0.258064516129032,0.471,35,60,0.583333333333333,"Lakers","Los Angeles",240,8,17,14,28,42,28,5,6,13,19,102,-3
"team",21900402,"IND",1610612754,41,85,0.482,10,25,0.4,0.65,31,60,0.516666666666667,"Pacers","Indiana",240,13,20,13,30,43,22,9,6,12,21,105,3
"team",21900403,"NYK",1610612752,53,95,0.558,13,28,0.464285714285714,0.774,40,67,0.597014925373134,"Knicks","New York",240,24,31,13,42,55,30,7,6,11,21,143,23
"team",21900403,"ATL",1610612737,45,99,0.455,15,43,0.348837209302326,0.75,30,56,0.535714285714286,"Hawks","Atlanta",240,15,20,9,27,36,20,7,3,10,21,120,-23
"team",21900404,"NOP",1610612740,37,107,0.346,11,40,0.275,0.667,26,67,0.388059701492537,"Pelicans","New Orleans",265,16,24,16,42,58,20,3,9,8,19,101,-7
"team",21900404,"BKN",1610612751,40,96,0.417,11,39,0.282051282051282,0.739,29,57,0.508771929824561,"Nets","Brooklyn",265,17,23,6,48,54,25,3,10,11,22,108,7
"team",21900405,"UTA",1610612762,42,90,0.467,15,36,0.416666666666667,0.625,27,54,0.5,"Jazz","Utah",240,10,16,10,48,58,27,3,3,14,16,109,7
"team",21900405,"ORL",1610612753,42,93,0.452,7,35,0.2,0.733,35,58,0.603448275862069,"Magic","Orlando",240,11,15,4,37,41,21,6,5,3,18,102,-7
"team",21900406,"PHX",1610612756,41,102,0.402,10,35,0.285714285714286,0.7,31,67,0.462686567164179,"Suns","Phoenix",240,7,10,16,34,50,30,11,3,19,23,99,-21
"team",21900406,"LAC",1610612746,45,89,0.506,14,32,0.4375,0.727,31,57,0.543859649122807,"Clippers","LA",240,16,22,6,38,44,23,14,4,15,15,120,21
"team",21900407,"CLE",1610612739,40,74,0.541,7,26,0.269230769230769,0.765,33,48,0.6875,"Cavaliers","Cleveland",240,13,17,10,38,48,25,7,3,23,21,100,2
"team",21900407,"CHA",1610612766,37,91,0.407,13,37,0.351351351351351,0.611,24,54,0.444444444444444,"Hornets","Charlotte",240,11,18,15,20,35,25,12,3,9,20,98,-2
"team",21900408,"TOR",1610612761,39,91,0.429,13,35,0.371428571428571,0.875,26,56,0.464285714285714,"Raptors","Toronto",240,21,24,12,35,47,27,9,6,12,20,112,13
"team",21900408,"DET",1610612765,39,87,0.448,6,35,0.171428571428571,0.682,33,52,0.634615384615385,"Pistons","Detroit",240,15,22,10,38,48,19,7,6,15,17,99,-13
"team",21900409,"WAS",1610612764,34,95,0.358,14,45,0.311111111111111,0.844,20,50,0.4,"Wizards","Washington",265,27,32,14,41,55,21,8,7,14,20,109,-1
"team",21900409,"CHI",1610612741,39,97,0.402,11,37,0.297297297297297,0.875,28,60,0.466666666666667,"Bulls","Chicago",265,21,24,11,42,53,25,10,6,15,24,110,1
"team",21900410,"PHI",1610612755,38,90,0.422,12,39,0.307692307692308,0.889,26,51,0.509803921568627,"76ers","Philadelphia",240,16,18,15,26,41,24,9,5,13,17,104,-4
"team",21900410,"MIA",1610612748,40,85,0.471,12,31,0.387096774193548,0.8,28,54,0.518518518518518,"Heat","Miami",240,16,20,11,36,47,26,6,4,12,14,108,4
"team",21900411,"NOP",1610612740,38,86,0.442,14,33,0.424242424242424,0.81,24,53,0.452830188679245,"Pelicans","New Orleans",240,17,21,11,44,55,23,6,4,17,19,107,8
"team",21900411,"MIN",1610612750,36,95,0.379,10,39,0.256410256410256,0.63,26,56,0.464285714285714,"Timberwolves","Minnesota",240,17,27,12,31,43,20,9,3,10,18,99,-8
"team",21900412,"OKC",1610612760,46,84,0.548,7,24,0.291666666666667,0.794,39,60,0.65,"Thunder","Oklahoma City",240,27,34,6,29,35,25,6,6,12,16,126,4
"team",21900412,"MEM",1610612763,50,99,0.505,10,26,0.384615384615385,0.8,40,73,0.547945205479452,"Grizzlies","Memphis",240,12,15,15,32,47,27,5,2,13,25,122,-4
"team",21900414,"ORL",1610612753,37,87,0.425,11,29,0.379310344827586,0.905,26,58,0.448275862068966,"Magic","Orlando",240,19,21,8,27,35,25,9,5,12,19,104,-9
"team",21900414,"DEN",1610612743,40,84,0.476,11,27,0.407407407407407,0.88,29,57,0.508771929824561,"Nuggets","Denver",240,22,25,14,38,52,28,8,3,17,17,113,9
"team",21900413,"DAL",1610612742,34,87,0.391,15,43,0.348837209302326,0.8,19,44,0.431818181818182,"Mavericks","Dallas",240,20,25,10,32,42,23,7,10,7,20,103,-6
"team",21900413,"BOS",1610612738,35,86,0.407,12,38,0.315789473684211,0.9,23,48,0.479166666666667,"Celtics","Boston",240,27,30,14,40,54,13,3,4,15,21,109,6
"team",21900415,"POR",1610612757,44,97,0.454,9,31,0.290322580645161,0.893,35,66,0.53030303030303,"Trail Blazers","Portland",240,25,28,14,43,57,19,6,8,10,22,122,10
"team",21900415,"GSW",1610612744,41,103,0.398,16,38,0.421052631578947,0.609,25,65,0.384615384615385,"Warriors","Golden State",240,14,23,17,33,50,24,7,7,8,23,112,-10
"team",21900416,"UTA",1610612762,39,83,0.47,6,24,0.25,0.711,33,59,0.559322033898305,"Jazz","Utah",240,27,38,13,40,53,18,8,6,18,17,111,5
"team",21900416,"ATL",1610612737,39,90,0.433,11,29,0.379310344827586,0.895,28,61,0.459016393442623,"Hawks","Atlanta",240,17,19,6,34,40,24,8,1,16,27,106,-5
"team",21900417,"MIL",1610612749,36,77,0.468,16,39,0.41025641025641,0.719,20,38,0.526315789473684,"Bucks","Milwaukee",240,23,32,8,32,40,22,14,7,13,25,111,7
"team",21900417,"LAL",1610612747,37,80,0.463,12,35,0.342857142857143,0.783,25,45,0.555555555555556,"Lakers","Los Angeles",240,18,23,7,31,38,24,4,6,18,24,104,-7
"team",21900418,"SAS",1610612759,43,96,0.448,13,33,0.393939393939394,0.826,30,63,0.476190476190476,"Spurs","San Antonio",240,19,23,13,34,47,26,10,8,11,19,118,13
"team",21900418,"BKN",1610612751,35,83,0.422,7,36,0.194444444444444,0.933,28,47,0.595744680851064,"Nets","Brooklyn",240,28,30,6,41,47,16,9,3,18,21,105,-13
"team",21900419,"LAC",1610612746,43,86,0.5,16,37,0.432432432432432,0.789,27,49,0.551020408163265,"Clippers","LA",240,15,19,7,31,38,23,10,7,18,24,117,-5
"team",21900419,"HOU",1610612745,43,86,0.5,14,37,0.378378378378378,0.759,29,49,0.591836734693878,"Rockets","Houston",240,22,29,10,33,43,23,9,4,18,20,122,5
"team",21900420,"MEM",1610612763,44,102,0.431,14,41,0.341463414634146,0.714,30,61,0.491803278688525,"Grizzlies","Memphis",240,5,7,10,36,46,31,9,8,7,17,107,-7
"team",21900420,"CLE",1610612739,40,92,0.435,17,37,0.459459459459459,0.739,23,55,0.418181818181818,"Cavaliers","Cleveland",240,17,23,16,44,60,26,4,10,14,12,114,7
"team",21900421,"SAC",1610612758,41,91,0.451,10,32,0.3125,0.867,31,59,0.525423728813559,"Kings","Sacramento",240,13,15,13,29,42,25,4,6,10,15,105,-14
"team",21900421,"IND",1610612754,45,86,0.523,14,31,0.451612903225806,0.833,31,55,0.563636363636364,"Pacers","Indiana",240,15,18,7,32,39,34,5,7,9,15,119,14
"team",21900422,"DET",1610612765,34,85,0.4,11,31,0.354838709677419,0.737,23,54,0.425925925925926,"Pistons","Detroit",240,14,19,11,25,36,21,13,2,24,16,93,-21
"team",21900422,"BOS",1610612738,45,86,0.523,9,27,0.333333333333333,0.714,36,59,0.610169491525424,"Celtics","Boston",240,15,21,13,38,51,24,13,9,20,19,114,21
"team",21900423,"WAS",1610612764,40,87,0.46,14,39,0.358974358974359,0.75,26,48,0.541666666666667,"Wizards","Washington",240,24,32,8,31,39,24,6,1,13,28,118,-4
"team",21900423,"TOR",1610612761,38,78,0.487,12,30,0.4,0.773,26,48,0.541666666666667,"Raptors","Toronto",240,34,44,6,36,42,26,6,3,17,25,122,4
"team",21900424,"NYK",1610612752,41,94,0.436,10,34,0.294117647058824,0.667,31,60,0.516666666666667,"Knicks","New York",240,22,33,13,28,41,23,11,2,8,25,114,-15
"team",21900424,"MIA",1610612748,43,77,0.558,18,38,0.473684210526316,0.735,25,39,0.641025641025641,"Heat","Miami",240,25,34,9,42,51,34,6,3,17,22,129,15
"team",21900425,"PHI",1610612755,38,90,0.422,10,34,0.294117647058824,0.667,28,56,0.5,"76ers","Philadelphia",240,12,18,11,35,46,25,9,2,15,16,98,-19
"team",21900425,"DAL",1610612742,43,83,0.518,14,33,0.424242424242424,0.773,29,50,0.58,"Mavericks","Dallas",240,17,22,8,41,49,23,10,4,16,17,117,19
"team",21900426,"PHX",1610612756,38,87,0.437,11,32,0.34375,0.913,27,55,0.490909090909091,"Suns","Phoenix",240,21,23,12,25,37,26,9,4,15,29,108,-18
"team",21900426,"OKC",1610612760,49,87,0.563,10,24,0.416666666666667,0.857,39,63,0.619047619047619,"Thunder","Oklahoma City",240,18,21,8,33,41,23,7,7,15,23,126,18
"team",21900427,"MIN",1610612750,36,87,0.414,10,42,0.238095238095238,0.667,26,45,0.577777777777778,"Timberwolves","Minnesota",240,18,27,16,30,46,20,8,8,14,15,100,-9
"team",21900427,"DEN",1610612743,44,89,0.494,10,28,0.357142857142857,0.917,34,61,0.557377049180328,"Nuggets","Denver",240,11,12,10,34,44,27,9,5,15,22,109,9
"team",21900428,"POR",1610612757,42,84,0.5,17,36,0.472222222222222,0.895,25,48,0.520833333333333,"Trail Blazers","Portland",240,17,19,11,43,54,16,4,11,20,24,118,15
"team",21900428,"ORL",1610612753,39,106,0.368,7,28,0.25,0.692,32,78,0.41025641025641,"Magic","Orlando",240,18,26,18,30,48,21,14,5,10,16,103,-15
"team",21900429,"NOP",1610612740,39,93,0.419,9,34,0.264705882352941,0.652,30,59,0.508474576271186,"Pelicans","New Orleans",240,15,23,13,35,48,23,8,5,17,19,102,-4
"team",21900429,"GSW",1610612744,36,83,0.434,10,33,0.303030303030303,0.96,26,50,0.52,"Warriors","Golden State",240,24,25,10,37,47,25,10,4,17,24,106,4
"team",21900430,"UTA",1610612762,39,75,0.52,17,34,0.5,0.95,22,41,0.536585365853659,"Jazz","Utah",240,19,20,8,34,42,27,7,4,21,27,114,7
"team",21900430,"CHA",1610612766,39,85,0.459,12,29,0.413793103448276,0.773,27,56,0.482142857142857,"Hornets","Charlotte",240,17,22,11,25,36,20,13,4,14,25,107,-7
"team",21900431,"BKN",1610612751,46,100,0.46,11,30,0.366666666666667,0.679,35,70,0.5,"Nets","Brooklyn",240,19,28,12,49,61,23,8,4,15,18,122,10
"team",21900431,"ATL",1610612737,39,105,0.371,11,48,0.229166666666667,0.852,28,57,0.491228070175439,"Hawks","Atlanta",240,23,27,14,38,52,17,7,5,10,22,112,-10
"team",21900432,"DET",1610612765,40,87,0.46,16,35,0.457142857142857,0.917,24,52,0.461538461538462,"Pistons","Detroit",240,11,12,6,23,29,30,14,4,16,20,107,-12
"team",21900432,"CHI",1610612741,40,77,0.519,18,35,0.514285714285714,0.84,22,42,0.523809523809524,"Bulls","Chicago",240,21,25,11,35,46,21,8,4,18,13,119,12
"team",21900433,"WAS",1610612764,36,88,0.409,7,31,0.225806451612903,0.853,29,57,0.508771929824561,"Wizards","Washington",240,29,34,7,31,38,18,7,3,11,21,108,-17
"team",21900433,"PHI",1610612755,49,94,0.521,14,33,0.424242424242424,0.619,35,61,0.573770491803279,"76ers","Philadelphia",240,13,21,16,37,53,28,7,4,14,26,125,17
"team",21900434,"NYK",1610612752,39,97,0.402,9,30,0.3,0.714,30,67,0.447761194029851,"Knicks","New York",240,15,21,9,38,47,23,10,6,14,27,102,-21
"team",21900434,"MIL",1610612749,41,85,0.482,18,43,0.418604651162791,0.657,23,42,0.547619047619048,"Bucks","Milwaukee",240,23,35,8,44,52,26,9,14,19,16,123,21
"team",21900435,"SAC",1610612758,43,100,0.43,11,36,0.305555555555556,0.75,32,64,0.5,"Kings","Sacramento",240,18,24,18,33,51,22,10,3,12,23,115,-4
"team",21900435,"MEM",1610612763,40,83,0.482,15,35,0.428571428571429,0.828,25,48,0.520833333333333,"Grizzlies","Memphis",240,24,29,8,36,44,32,8,6,14,16,119,4
"team",21900436,"SAS",1610612759,42,82,0.512,10,28,0.357142857142857,0.789,32,54,0.592592592592593,"Spurs","San Antonio",240,15,19,4,32,36,24,5,8,18,20,109,-25
"team",21900436,"LAC",1610612746,54,99,0.545,12,36,0.333333333333333,0.737,42,63,0.666666666666667,"Clippers","LA",240,14,19,13,30,43,32,11,2,11,19,134,25
"team",21900437,"PHX",1610612756,47,91,0.516,8,28,0.285714285714286,0.767,39,63,0.619047619047619,"Suns","Phoenix",240,23,30,10,31,41,26,5,1,8,18,125,-14
"team",21900437,"HOU",1610612745,51,87,0.586,19,41,0.463414634146341,0.783,32,46,0.695652173913043,"Rockets","Houston",240,18,23,5,32,37,23,4,5,10,23,139,14
"team",21900438,"POR",1610612757,40,94,0.426,13,35,0.371428571428571,0.8,27,59,0.457627118644068,"Trail Blazers","Portland",240,20,25,12,33,45,19,9,13,14,21,113,7
"team",21900438,"MIN",1610612750,38,87,0.437,15,37,0.405405405405405,0.938,23,50,0.46,"Timberwolves","Minnesota",240,15,16,7,32,39,16,8,8,16,18,106,-7
"team",21900439,"TOR",1610612761,37,94,0.394,10,34,0.294117647058824,0.839,27,60,0.45,"Raptors","Toronto",240,26,31,14,37,51,21,12,5,10,21,110,3
"team",21900439,"DAL",1610612742,35,90,0.389,15,46,0.326086956521739,0.815,20,44,0.454545454545455,"Mavericks","Dallas",240,22,27,14,39,53,27,6,4,17,22,107,-3
"team",21900440,"CHA",1610612766,33,82,0.402,10,34,0.294117647058824,0.739,23,48,0.479166666666667,"Hornets","Charlotte",240,17,23,2,25,27,26,3,5,3,17,93,-26
"team",21900440,"BOS",1610612738,46,88,0.523,14,32,0.4375,0.813,32,56,0.571428571428571,"Celtics","Boston",240,13,16,10,47,57,25,2,9,11,24,119,26
"team",21900441,"MIL",1610612749,44,104,0.423,15,44,0.340909090909091,0.824,29,60,0.483333333333333,"Bucks","Milwaukee",240,14,17,16,45,61,31,10,9,9,7,117,28
"team",21900441,"IND",1610612754,37,100,0.37,12,40,0.3,0.6,25,60,0.416666666666667,"Pacers","Indiana",240,3,5,10,38,48,27,7,5,13,15,89,-28
"team",21900442,"OKC",1610612760,46,97,0.474,9,27,0.333333333333333,0.85,37,70,0.528571428571429,"Thunder","Oklahoma City",240,17,20,16,33,49,24,10,4,12,20,118,6
"team",21900442,"LAC",1610612746,40,86,0.465,11,27,0.407407407407407,0.875,29,59,0.491525423728814,"Clippers","LA",240,21,24,10,32,42,22,7,2,15,23,112,-6
"team",21900443,"LAL",1610612747,39,83,0.47,10,29,0.344827586206897,0.727,29,54,0.537037037037037,"Lakers","Los Angeles",240,16,22,18,27,45,18,7,9,19,25,104,-24
"team",21900443,"DEN",1610612743,45,92,0.489,11,32,0.34375,0.9,34,60,0.566666666666667,"Nuggets","Denver",240,27,30,17,27,44,31,13,2,8,19,128,24
"team",21900444,"CLE",1610612739,50,96,0.521,11,29,0.379310344827586,0.833,39,67,0.582089552238806,"Cavaliers","Cleveland",240,10,12,7,36,43,19,8,6,23,16,121,3
"team",21900444,"ATL",1610612737,45,95,0.474,15,42,0.357142857142857,0.765,30,53,0.566037735849057,"Hawks","Atlanta",240,13,17,5,32,37,23,11,7,16,20,118,-3
"team",21900445,"PHI",1610612755,52,95,0.547,12,30,0.4,0.818,40,65,0.615384615384615,"76ers","Philadelphia",240,9,11,17,31,48,33,8,8,12,21,125,16
"team",21900445,"DET",1610612765,43,84,0.512,10,30,0.333333333333333,0.722,33,54,0.611111111111111,"Pistons","Detroit",240,13,18,6,24,30,27,9,1,13,14,109,-16
"team",21900446,"TOR",1610612761,43,94,0.457,11,40,0.275,0.75,32,54,0.592592592592593,"Raptors","Toronto",265,18,24,11,38,49,30,5,9,14,22,115,-5
"team",21900446,"IND",1610612754,45,95,0.474,18,42,0.428571428571429,0.6,27,53,0.509433962264151,"Pacers","Indiana",265,12,20,13,33,46,34,5,8,11,22,120,5
"team",21900447,"WAS",1610612764,47,100,0.47,10,30,0.333333333333333,0.567,37,70,0.528571428571429,"Wizards","Washington",240,17,30,16,32,48,27,12,7,8,12,121,6
"team",21900447,"NYK",1610612752,44,93,0.473,15,36,0.416666666666667,0.8,29,57,0.508771929824561,"Knicks","New York",240,12,15,11,33,44,29,4,10,14,25,115,-6
"team",21900448,"ORL",1610612753,39,82,0.476,10,26,0.384615384615385,0.652,29,56,0.517857142857143,"Magic","Orlando",240,15,23,6,40,46,23,10,13,12,15,103,8
"team",21900448,"CHI",1610612741,35,88,0.398,13,37,0.351351351351351,0.8,22,51,0.431372549019608,"Bulls","Chicago",240,12,15,11,37,48,20,6,6,15,17,95,-8
"team",21900449,"UTA",1610612762,39,90,0.433,12,36,0.333333333333333,0.778,27,54,0.5,"Jazz","Utah",240,14,18,11,35,46,17,9,6,11,21,104,-3
"team",21900449,"MIA",1610612748,37,90,0.411,9,25,0.36,0.889,28,65,0.430769230769231,"Heat","Miami",240,24,27,13,42,55,16,8,3,13,16,107,3
"team",21900450,"SAS",1610612759,60,89,0.674,15,24,0.625,0.714,45,65,0.692307692307692,"Spurs","San Antonio",240,10,14,4,42,46,36,9,4,12,14,145,30
"team",21900450,"MEM",1610612763,45,96,0.469,15,37,0.405405405405405,0.625,30,59,0.508474576271186,"Grizzlies","Memphis",240,10,16,11,24,35,28,7,0,13,19,115,-30
"team",21900451,"PHX",1610612756,42,87,0.483,13,37,0.351351351351351,0.778,29,50,0.58,"Suns","Phoenix",240,14,18,9,29,38,29,10,0,17,19,111,-2
"team",21900451,"DEN",1610612743,43,78,0.551,15,28,0.535714285714286,0.8,28,50,0.56,"Nuggets","Denver",240,12,15,6,33,39,31,10,1,21,24,113,2
"team",21900452,"POR",1610612757,37,91,0.407,4,29,0.137931034482759,0.889,33,62,0.532258064516129,"Trail Blazers","Portland",240,16,18,8,40,48,17,6,6,11,17,94,-8
"team",21900452,"NOP",1610612740,38,93,0.409,15,35,0.428571428571429,0.688,23,58,0.396551724137931,"Pelicans","New Orleans",240,11,16,13,42,55,23,6,6,12,19,102,8
"team",21900453,"SAC",1610612758,41,87,0.471,7,30,0.233333333333333,0.652,34,57,0.596491228070175,"Kings","Sacramento",240,15,23,11,38,49,20,4,4,17,24,104,-9
"team",21900453,"HOU",1610612745,39,87,0.448,15,39,0.384615384615385,0.87,24,48,0.5,"Rockets","Houston",240,20,23,6,33,39,18,10,3,11,22,113,9
"team",21900454,"MIN",1610612750,35,88,0.398,11,34,0.323529411764706,0.793,24,54,0.444444444444444,"Timberwolves","Minnesota",240,23,29,10,31,41,16,10,6,16,18,104,-9
"team",21900454,"GSW",1610612744,38,86,0.442,12,30,0.4,0.833,26,56,0.464285714285714,"Warriors","Golden State",240,25,30,13,42,55,27,11,6,19,27,113,9
"team",21900455,"TOR",1610612761,38,80,0.475,8,23,0.347826086956522,0.818,30,57,0.526315789473684,"Raptors","Toronto",240,18,22,7,27,34,17,13,7,17,13,102,-16
"team",21900455,"BOS",1610612738,46,92,0.5,14,33,0.424242424242424,0.857,32,59,0.542372881355932,"Celtics","Boston",240,12,14,13,32,45,26,7,3,19,22,118,16
"team",21900456,"PHI",1610612755,44,101,0.436,21,44,0.477272727272727,0.8,23,57,0.403508771929825,"76ers","Philadelphia",240,12,15,14,35,49,29,9,7,7,12,121,12
"team",21900456,"MIL",1610612749,45,95,0.474,13,33,0.393939393939394,0.75,32,62,0.516129032258065,"Bucks","Milwaukee",240,6,8,8,39,47,23,6,6,10,15,109,-12
"team",21900457,"HOU",1610612745,37,100,0.37,16,51,0.313725490196078,0.875,21,49,0.428571428571429,"Rockets","Houston",240,14,16,14,35,49,19,8,3,12,25,104,-12
"team",21900457,"GSW",1610612744,41,87,0.471,9,28,0.321428571428571,0.893,32,59,0.542372881355932,"Warriors","Golden State",240,25,28,11,43,54,27,7,8,16,18,116,12
"team",21900458,"LAL",1610612747,39,96,0.406,12,45,0.266666666666667,0.762,27,51,0.529411764705882,"Lakers","Los Angeles",240,16,21,12,30,42,24,11,10,13,23,106,-5
"team",21900458,"LAC",1610612746,39,85,0.459,9,25,0.36,0.75,30,60,0.5,"Clippers","LA",240,24,32,13,37,50,24,6,6,16,17,111,5
"team",21900459,"NOP",1610612740,41,90,0.456,18,43,0.418604651162791,1,23,47,0.48936170212766,"Pelicans","New Orleans",240,12,12,14,38,52,23,9,5,18,14,112,12
"team",21900459,"DEN",1610612743,37,92,0.402,12,37,0.324324324324324,0.778,25,55,0.454545454545455,"Nuggets","Denver",240,14,18,13,27,40,24,10,4,12,15,100,-12
"team",21900460,"WAS",1610612764,38,92,0.413,7,24,0.291666666666667,0.704,31,68,0.455882352941176,"Wizards","Washington",240,19,27,18,26,44,18,7,5,12,25,102,-30
"team",21900460,"DET",1610612765,46,86,0.535,19,48,0.395833333333333,0.808,27,38,0.710526315789474,"Pistons","Detroit",240,21,26,11,37,48,32,5,5,14,23,132,30
"team",21900461,"NYK",1610612752,37,92,0.402,9,29,0.310344827586207,0.733,28,63,0.444444444444444,"Knicks","New York",240,11,15,13,47,60,16,6,2,13,27,94,12
"team",21900461,"BKN",1610612751,21,78,0.269,13,50,0.26,0.75,8,28,0.285714285714286,"Nets","Brooklyn",240,27,36,9,41,50,17,3,3,13,19,82,-12
"team",21900462,"OKC",1610612760,38,92,0.413,10,35,0.285714285714286,0.846,28,57,0.491228070175439,"Thunder","Oklahoma City",240,11,13,7,27,34,23,11,4,9,14,97,-13
"team",21900462,"MEM",1610612763,46,84,0.548,10,25,0.4,0.727,36,59,0.610169491525424,"Grizzlies","Memphis",240,8,11,8,42,50,26,6,8,15,14,110,13
"team",21900463,"SAS",1610612759,40,83,0.482,8,29,0.275862068965517,0.667,32,54,0.592592592592593,"Spurs","San Antonio",240,10,15,5,40,45,18,9,7,13,16,98,-4
"team",21900463,"DAL",1610612742,38,90,0.422,16,40,0.4,0.667,22,50,0.44,"Mavericks","Dallas",240,10,15,13,39,52,22,7,3,14,11,102,4
"team",21900464,"SAC",1610612758,37,107,0.346,9,39,0.230769230769231,0.84,28,68,0.411764705882353,"Kings","Sacramento",290,21,25,16,51,67,20,8,8,12,23,104,-1
"team",21900464,"MIN",1610612750,36,104,0.346,10,46,0.217391304347826,0.793,26,58,0.448275862068966,"Timberwolves","Minnesota",290,23,29,14,51,65,23,7,5,13,20,105,1
"team",21900465,"UTA",1610612762,46,81,0.568,14,36,0.388888888888889,0.682,32,45,0.711111111111111,"Jazz","Utah",240,15,22,7,34,41,22,3,1,10,18,121,6
"team",21900465,"POR",1610612757,43,89,0.483,15,34,0.441176470588235,0.737,28,55,0.509090909090909,"Trail Blazers","Portland",240,14,19,11,32,43,14,4,1,12,21,115,-6
"team",21900466,"CLE",1610612739,44,85,0.518,9,23,0.391304347826087,0.69,35,62,0.564516129032258,"Cavaliers","Cleveland",240,20,29,6,32,38,22,7,3,11,17,117,-12
"team",21900466,"BOS",1610612738,49,95,0.516,14,40,0.35,0.895,35,55,0.636363636363636,"Celtics","Boston",240,17,19,12,31,43,28,4,10,11,23,129,12
"team",21900467,"OKC",1610612760,40,89,0.449,5,31,0.161290322580645,0.613,35,58,0.603448275862069,"Thunder","Oklahoma City",265,19,31,10,39,49,19,8,4,14,23,104,2
"team",21900467,"CHA",1610612766,42,101,0.416,7,39,0.179487179487179,0.611,35,62,0.564516129032258,"Hornets","Charlotte",265,11,18,17,37,54,26,8,4,15,27,102,-2
"team",21900468,"PHI",1610612755,35,87,0.402,10,29,0.344827586206897,0.81,25,58,0.431034482758621,"76ers","Philadelphia",240,17,21,7,38,45,23,10,3,15,22,97,-1
"team",21900468,"ORL",1610612753,37,88,0.42,10,30,0.333333333333333,0.609,27,58,0.46551724137931,"Magic","Orlando",240,14,23,10,38,48,26,4,5,15,21,98,1
"team",21900469,"MIL",1610612749,46,91,0.505,11,28,0.392857142857143,0.692,35,63,0.555555555555556,"Bucks","Milwaukee",240,9,13,6,50,56,29,9,8,18,13,112,26
"team",21900469,"ATL",1610612737,33,91,0.363,12,41,0.292682926829268,0.571,21,50,0.42,"Hawks","Atlanta",240,8,14,8,38,46,20,10,8,18,18,86,-26
"team",21900470,"MIA",1610612748,40,89,0.449,16,38,0.421052631578947,0.895,24,51,0.470588235294118,"Heat","Miami",240,17,19,14,42,56,29,3,2,13,12,113,1
"team",21900470,"IND",1610612754,44,90,0.489,14,31,0.451612903225806,0.833,30,59,0.508474576271186,"Pacers","Indiana",240,10,12,2,32,34,27,8,4,4,16,112,-1
"team",21900471,"PHX",1610612756,35,75,0.467,7,33,0.212121212121212,0.792,28,42,0.666666666666667,"Suns","Phoenix",240,19,24,11,38,49,22,6,1,26,21,96,-9
"team",21900471,"GSW",1610612744,38,92,0.413,9,27,0.333333333333333,0.8,29,65,0.446153846153846,"Warriors","Golden State",240,20,25,11,30,41,22,10,5,10,17,105,9
"team",21900472,"MEM",1610612763,41,84,0.488,9,30,0.3,0.76,32,54,0.592592592592593,"Grizzlies","Memphis",240,19,25,11,34,45,32,5,5,17,24,110,-9
"team",21900472,"DEN",1610612743,45,93,0.484,9,29,0.310344827586207,0.741,36,64,0.5625,"Nuggets","Denver",240,20,27,10,33,43,28,9,4,10,20,119,9
"team",21900473,"TOR",1610612761,44,84,0.524,14,34,0.411764705882353,0.647,30,50,0.6,"Raptors","Toronto",240,11,17,15,38,53,27,8,3,22,32,113,16
"team",21900473,"BOS",1610612738,31,78,0.397,7,32,0.21875,0.778,24,46,0.521739130434783,"Celtics","Boston",240,28,36,7,24,31,18,11,4,14,17,97,-16
"team",21900474,"NOP",1610612740,43,93,0.462,18,42,0.428571428571429,0.8,25,51,0.490196078431373,"Pelicans","New Orleans",240,16,20,11,38,49,25,9,2,12,18,120,22
"team",21900474,"IND",1610612754,33,85,0.388,6,28,0.214285714285714,0.897,27,57,0.473684210526316,"Pacers","Indiana",240,26,29,12,34,46,17,6,2,18,16,98,-22
"team",21900475,"PHI",1610612755,42,89,0.472,10,30,0.333333333333333,0.759,32,59,0.542372881355932,"76ers","Philadelphia",265,22,29,8,39,47,24,5,4,9,24,116,-1
"team",21900475,"MIA",1610612748,42,94,0.447,10,28,0.357142857142857,0.793,32,66,0.484848484848485,"Heat","Miami",265,23,29,8,35,43,26,6,4,8,21,117,1
"team",21900476,"WAS",1610612764,33,96,0.344,10,25,0.4,0.774,23,71,0.323943661971831,"Wizards","Washington",240,24,31,14,35,49,16,15,3,11,22,100,-7
"team",21900476,"NYK",1610612752,38,85,0.447,11,31,0.354838709677419,0.769,27,54,0.5,"Knicks","New York",240,20,26,11,45,56,25,5,5,21,25,107,7
"team",21900477,"CHI",1610612741,43,87,0.494,15,31,0.483870967741935,0.789,28,56,0.5,"Bulls","Chicago",240,15,19,13,38,51,22,13,5,17,15,116,35
"team",21900477,"ATL",1610612737,32,86,0.372,9,34,0.264705882352941,0.727,23,52,0.442307692307692,"Hawks","Atlanta",240,8,11,9,30,39,24,8,5,19,16,81,-35
"team",21900478,"HOU",1610612745,44,101,0.436,13,42,0.30952380952381,0.438,31,59,0.525423728813559,"Rockets","Houston",240,7,16,16,38,54,16,7,6,14,15,108,10
"team",21900478,"BKN",1610612751,37,92,0.402,11,39,0.282051282051282,0.619,26,53,0.490566037735849,"Nets","Brooklyn",240,13,21,9,38,47,24,7,5,15,15,98,-10
"team",21900479,"MIN",1610612750,33,93,0.355,8,37,0.216216216216216,0.737,25,56,0.446428571428571,"Timberwolves","Minnesota",240,14,19,14,26,40,17,17,8,18,29,88,-6
"team",21900479,"CLE",1610612739,32,77,0.416,4,20,0.2,0.722,28,57,0.491228070175439,"Cavaliers","Cleveland",240,26,36,14,46,60,13,9,4,28,21,94,6
"team",21900480,"ORL",1610612753,35,87,0.402,14,35,0.4,0.842,21,52,0.403846153846154,"Magic","Orlando",240,16,19,5,29,34,21,16,7,11,17,100,-11
"team",21900480,"MIL",1610612749,43,84,0.512,13,37,0.351351351351351,0.667,30,47,0.638297872340426,"Bucks","Milwaukee",240,12,18,14,44,58,30,6,5,23,13,111,11
"team",21900481,"SAS",1610612759,53,93,0.57,18,35,0.514285714285714,0.8,35,58,0.603448275862069,"Spurs","San Antonio",240,12,15,7,44,51,30,8,7,11,20,136,27
"team",21900481,"DET",1610612765,40,90,0.444,12,36,0.333333333333333,0.567,28,54,0.518518518518518,"Pistons","Detroit",240,17,30,10,30,40,20,9,5,11,15,109,-27
"team",21900482,"GSW",1610612744,45,93,0.484,18,39,0.461538461538462,0.765,27,54,0.5,"Warriors","Golden State",240,13,17,9,33,42,28,4,3,13,19,121,-20
"team",21900482,"DAL",1610612742,48,92,0.522,24,51,0.470588235294118,1,24,41,0.585365853658537,"Mavericks","Dallas",240,21,21,9,37,46,35,11,7,13,17,141,20
"team",21900483,"SAC",1610612758,41,84,0.488,12,31,0.387096774193548,0.667,29,53,0.547169811320755,"Kings","Sacramento",240,16,24,7,29,36,19,3,4,12,16,110,-2
"team",21900483,"PHX",1610612756,45,86,0.523,9,26,0.346153846153846,0.867,36,60,0.6,"Suns","Phoenix",240,13,15,7,33,40,30,10,2,13,21,112,2
"team",21900484,"POR",1610612757,41,86,0.477,15,35,0.428571428571429,0.852,26,51,0.509803921568627,"Trail Blazers","Portland",240,23,27,9,30,39,18,4,8,16,22,120,-8
"team",21900484,"LAL",1610612747,47,91,0.516,11,32,0.34375,0.821,36,59,0.610169491525424,"Lakers","Los Angeles",240,23,28,11,33,44,32,6,7,9,25,128,8
"team",21900485,"UTA",1610612762,45,86,0.523,17,35,0.485714285714286,0.765,28,51,0.549019607843137,"Jazz","Utah",240,13,17,6,41,47,25,4,2,12,20,120,13
"team",21900485,"LAC",1610612746,35,95,0.368,12,40,0.3,0.926,23,55,0.418181818181818,"Clippers","LA",240,25,27,16,30,46,22,9,4,7,18,107,-13
"team",21900486,"TOR",1610612761,35,83,0.422,15,40,0.375,1,20,43,0.465116279069767,"Raptors","Toronto",240,12,12,8,34,42,21,7,2,14,20,97,-1
"team",21900486,"OKC",1610612760,34,78,0.436,10,33,0.303030303030303,0.87,24,45,0.533333333333333,"Thunder","Oklahoma City",240,20,23,8,35,43,15,8,6,17,14,98,1
"team",21900487,"MEM",1610612763,45,93,0.484,10,35,0.285714285714286,1,35,58,0.603448275862069,"Grizzlies","Memphis",240,17,17,14,37,51,30,5,5,14,20,117,13
"team",21900487,"CHA",1610612766,37,86,0.43,9,31,0.290322580645161,0.656,28,55,0.509090909090909,"Hornets","Charlotte",240,21,32,11,31,42,23,8,4,14,19,104,-13
"team",21900488,"NOP",1610612740,50,102,0.49,18,44,0.409090909090909,0.692,32,58,0.551724137931034,"Pelicans","New Orleans",240,9,13,14,32,46,32,9,4,9,17,127,15
"team",21900488,"HOU",1610612745,42,81,0.519,15,39,0.384615384615385,0.65,27,42,0.642857142857143,"Rockets","Houston",240,13,20,8,33,41,29,5,3,17,16,112,-15
"team",21900489,"SAC",1610612758,45,85,0.529,13,34,0.382352941176471,0.706,32,51,0.627450980392157,"Kings","Sacramento",240,12,17,9,26,35,32,5,4,12,26,115,-5
"team",21900489,"DEN",1610612743,42,81,0.519,8,29,0.275862068965517,0.903,34,52,0.653846153846154,"Nuggets","Denver",240,28,31,10,27,37,23,6,4,12,18,120,5
"team",21900490,"LAL",1610612747,38,78,0.487,9,23,0.391304347826087,0.821,29,55,0.527272727272727,"Lakers","Los Angeles",240,23,28,6,33,39,28,12,7,16,23,108,13
"team",21900490,"DAL",1610612742,32,89,0.36,13,43,0.302325581395349,0.9,19,46,0.41304347826087,"Mavericks","Dallas",240,18,20,13,32,45,17,11,4,18,23,95,-13
"team",21900491,"ORL",1610612753,37,89,0.416,5,25,0.2,0.583,32,64,0.5,"Magic","Orlando",240,14,24,11,29,40,22,9,6,9,17,93,-8
"team",21900491,"ATL",1610612737,39,81,0.481,9,29,0.310344827586207,0.824,30,52,0.576923076923077,"Hawks","Atlanta",240,14,17,11,41,52,21,8,4,20,20,101,8
"team",21900492,"WAS",1610612764,43,84,0.512,17,37,0.459459459459459,0.667,26,47,0.553191489361702,"Wizards","Washington",240,20,30,9,31,40,26,13,6,9,27,123,18
"team",21900492,"MIA",1610612748,33,73,0.452,10,28,0.357142857142857,0.744,23,45,0.511111111111111,"Heat","Miami",240,29,39,10,34,44,18,5,1,18,22,105,-18
"team",21900493,"MIL",1610612749,46,84,0.548,11,32,0.34375,0.833,35,52,0.673076923076923,"Bucks","Milwaukee",240,20,24,10,49,59,29,6,9,16,17,123,21
"team",21900493,"CHI",1610612741,40,107,0.374,17,44,0.386363636363636,0.625,23,63,0.365079365079365,"Bulls","Chicago",240,5,8,14,29,43,26,10,2,10,20,102,-21
"team",21900494,"MIN",1610612750,42,104,0.404,17,44,0.386363636363636,0.724,25,60,0.416666666666667,"Timberwolves","Minnesota",265,21,29,11,49,60,20,12,8,14,22,122,7
"team",21900494,"BKN",1610612751,40,99,0.404,15,41,0.365853658536585,0.741,25,58,0.431034482758621,"Nets","Brooklyn",265,20,27,7,51,58,22,4,6,16,25,115,-7
"team",21900495,"UTA",1610612762,39,83,0.47,10,26,0.384615384615385,0.8,29,57,0.508771929824561,"Jazz","Utah",240,16,20,9,37,46,20,7,6,14,21,104,23
"team",21900495,"DET",1610612765,30,79,0.38,4,14,0.285714285714286,0.739,26,65,0.4,"Pistons","Detroit",240,17,23,10,33,43,14,10,5,17,20,81,-23
"team",21900496,"POR",1610612757,44,96,0.458,14,34,0.411764705882353,0.778,30,62,0.483870967741935,"Trail Blazers","Portland",240,14,18,10,32,42,24,5,4,8,19,116,-6
"team",21900496,"PHX",1610612756,44,92,0.478,13,23,0.565217391304348,0.955,31,69,0.449275362318841,"Suns","Phoenix",240,21,22,10,34,44,29,6,4,9,17,122,6
"team",21900497,"CHA",1610612766,34,86,0.395,12,34,0.352941176470588,0.75,22,52,0.423076923076923,"Hornets","Charlotte",240,12,16,8,33,41,25,7,4,17,16,92,-17
"team",21900497,"BOS",1610612738,44,97,0.454,14,38,0.368421052631579,0.7,30,59,0.508474576271186,"Celtics","Boston",240,7,10,15,39,54,25,12,9,10,16,109,17
"team",21900498,"PHI",1610612755,37,91,0.407,6,29,0.206896551724138,0.85,31,62,0.5,"76ers","Philadelphia",240,17,20,14,33,47,24,4,6,12,22,97,-18
"team",21900498,"IND",1610612754,42,86,0.488,11,25,0.44,0.769,31,61,0.508196721311475,"Pacers","Indiana",240,20,26,5,33,38,35,3,6,6,16,115,18
"team",21900499,"SAC",1610612758,33,80,0.412,8,28,0.285714285714286,0.684,25,52,0.480769230769231,"Kings","Sacramento",240,13,19,11,30,41,20,8,5,15,23,87,-18
"team",21900499,"LAC",1610612746,36,88,0.409,12,36,0.333333333333333,0.955,24,52,0.461538461538462,"Clippers","LA",240,21,22,14,37,51,21,9,2,11,17,105,18
"team",21900500,"TOR",1610612761,40,84,0.476,17,39,0.435897435897436,0.8,23,45,0.511111111111111,"Raptors","Toronto",240,20,25,10,35,45,29,5,7,11,15,117,20
"team",21900500,"CLE",1610612739,37,87,0.425,10,38,0.263157894736842,0.813,27,49,0.551020408163265,"Cavaliers","Cleveland",240,13,16,8,33,41,21,5,4,14,19,97,-20
"team",21900501,"HOU",1610612745,46,87,0.529,16,34,0.470588235294118,0.71,30,53,0.566037735849057,"Rockets","Houston",240,22,31,13,30,43,20,6,7,15,17,130,26
"team",21900501,"DEN",1610612743,45,97,0.464,8,25,0.32,0.667,37,72,0.513888888888889,"Nuggets","Denver",240,6,9,14,25,39,25,7,5,16,22,104,-26
"team",21900502,"SAS",1610612759,45,96,0.469,14,31,0.451612903225806,0.765,31,65,0.476923076923077,"Spurs","San Antonio",265,13,17,10,43,53,30,6,6,10,18,117,4
"team",21900502,"GSW",1610612744,44,96,0.458,12,27,0.444444444444444,0.722,32,69,0.463768115942029,"Warriors","Golden State",265,13,18,9,35,44,31,5,6,8,14,113,-4
"team",21900503,"OKC",1610612760,39,91,0.429,6,27,0.222222222222222,0.786,33,64,0.515625,"Thunder","Oklahoma City",240,22,28,18,38,56,18,7,5,11,21,106,5
"team",21900503,"DAL",1610612742,33,93,0.355,15,51,0.294117647058824,0.741,18,42,0.428571428571429,"Mavericks","Dallas",240,20,27,17,32,49,19,5,4,10,24,101,-5
"team",21900504,"WAS",1610612764,33,87,0.379,9,31,0.290322580645161,0.839,24,56,0.428571428571429,"Wizards","Washington",240,26,31,9,37,46,18,5,4,13,23,101,-21
"team",21900504,"ORL",1610612753,45,95,0.474,12,32,0.375,0.741,33,63,0.523809523809524,"Magic","Orlando",240,20,27,11,41,52,25,11,6,9,21,122,21
"team",21900505,"POR",1610612757,37,94,0.394,10,32,0.3125,0.6,27,62,0.435483870967742,"Trail Blazers","Portland",240,9,15,10,37,47,17,4,5,8,11,93,-24
"team",21900505,"NYK",1610612752,47,98,0.48,14,36,0.388888888888889,0.643,33,62,0.532258064516129,"Knicks","New York",240,9,14,9,46,55,29,3,6,7,14,117,24
"team",21900506,"MIN",1610612750,34,91,0.374,15,46,0.326086956521739,0.75,19,45,0.422222222222222,"Timberwolves","Minnesota",240,21,28,6,42,48,18,7,8,11,25,104,-2
"team",21900506,"MIL",1610612749,40,94,0.426,9,36,0.25,0.654,31,58,0.53448275862069,"Bucks","Milwaukee",240,17,26,12,48,60,24,4,12,17,22,106,2
"team",21900507,"PHX",1610612756,42,86,0.488,6,23,0.260869565217391,0.739,36,63,0.571428571428571,"Suns","Phoenix",240,17,23,11,36,47,32,7,3,14,28,107,-10
"team",21900507,"LAL",1610612747,43,90,0.478,7,28,0.25,0.706,36,62,0.580645161290323,"Lakers","Los Angeles",240,24,34,13,32,45,25,9,5,12,17,117,10
"team",21900508,"CLE",1610612739,41,81,0.506,13,35,0.371428571428571,0.786,28,46,0.608695652173913,"Cavaliers","Cleveland",240,11,14,7,35,42,26,6,3,14,22,106,-3
"team",21900508,"CHA",1610612766,37,83,0.446,15,38,0.394736842105263,0.833,22,45,0.488888888888889,"Hornets","Charlotte",240,20,24,10,29,39,25,5,0,11,15,109,3
"team",21900509,"IND",1610612754,43,82,0.524,12,26,0.461538461538462,0.72,31,56,0.553571428571429,"Pacers","Indiana",240,18,25,9,25,34,32,7,3,9,21,116,-8
"team",21900509,"DEN",1610612743,46,87,0.529,8,27,0.296296296296296,0.889,38,60,0.633333333333333,"Nuggets","Denver",240,24,27,15,32,47,27,7,1,10,21,124,8
"team",21900510,"TOR",1610612761,28,89,0.315,6,42,0.142857142857143,0.824,22,47,0.468085106382979,"Raptors","Toronto",240,14,17,13,35,48,20,5,6,10,12,76,-8
"team",21900510,"MIA",1610612748,33,81,0.407,12,37,0.324324324324324,0.545,21,44,0.477272727272727,"Heat","Miami",240,6,11,9,41,50,23,6,4,14,13,84,8
"team",21900511,"UTA",1610612762,37,76,0.487,11,30,0.366666666666667,0.773,26,46,0.565217391304348,"Jazz","Utah",240,17,22,7,35,42,24,5,6,17,17,102,4
"team",21900511,"CHI",1610612741,37,94,0.394,11,36,0.305555555555556,0.765,26,58,0.448275862068966,"Bulls","Chicago",240,13,17,15,30,45,22,8,5,10,15,98,-4
"team",21900512,"MIN",1610612750,38,95,0.4,13,43,0.302325581395349,0.588,25,52,0.480769230769231,"Timberwolves","Minnesota",240,10,17,17,35,52,22,7,7,12,20,99,15
"team",21900512,"GSW",1610612744,33,77,0.429,3,20,0.15,0.714,30,57,0.526315789473684,"Warriors","Golden State",240,15,21,7,36,43,20,9,1,16,20,84,-15
"team",21900513,"DAL",1610612742,45,90,0.5,18,39,0.461538461538462,0.882,27,51,0.529411764705882,"Mavericks","Dallas",240,15,17,12,34,46,22,4,8,13,21,123,12
"team",21900513,"BKN",1610612751,42,91,0.462,12,37,0.324324324324324,0.882,30,54,0.555555555555556,"Nets","Brooklyn",240,15,17,12,32,44,29,5,1,11,21,111,-12
"team",21900514,"SAS",1610612759,40,92,0.435,13,31,0.419354838709677,0.833,27,61,0.442622950819672,"Spurs","San Antonio",240,10,12,14,31,45,22,1,8,8,22,103,-6
"team",21900514,"OKC",1610612760,43,89,0.483,9,25,0.36,0.7,34,64,0.53125,"Thunder","Oklahoma City",240,14,20,8,35,43,19,7,6,4,14,109,6
"team",21900515,"SAC",1610612758,44,90,0.489,14,34,0.411764705882353,0.839,30,56,0.535714285714286,"Kings","Sacramento",240,26,31,7,34,41,26,9,8,12,24,128,5
"team",21900515,"MEM",1610612763,45,93,0.484,13,34,0.382352941176471,0.952,32,59,0.542372881355932,"Grizzlies","Memphis",240,20,21,8,34,42,31,4,0,17,25,123,-5
"team",21900516,"LAC",1610612746,50,92,0.543,11,28,0.392857142857143,0.714,39,64,0.609375,"Clippers","LA",240,15,21,11,40,51,29,6,11,15,22,126,14
"team",21900516,"DET",1610612765,40,94,0.426,7,33,0.212121212121212,0.714,33,61,0.540983606557377,"Pistons","Detroit",240,25,35,12,33,45,20,10,1,11,23,112,-14
"team",21900517,"BOS",1610612738,41,93,0.441,6,25,0.24,0.724,35,68,0.514705882352941,"Celtics","Boston",240,21,29,12,42,54,23,9,7,12,16,109,3
"team",21900517,"ATL",1610612737,39,93,0.419,16,45,0.355555555555556,0.8,23,48,0.479166666666667,"Hawks","Atlanta",240,12,15,6,36,42,26,6,5,14,24,106,-3
"team",21900518,"ORL",1610612753,33,81,0.407,13,35,0.371428571428571,0.897,20,46,0.434782608695652,"Magic","Orlando",240,26,29,7,37,44,25,11,4,10,17,105,20
"team",21900518,"MIA",1610612748,30,80,0.375,7,37,0.189189189189189,0.783,23,43,0.534883720930233,"Heat","Miami",240,18,23,10,39,49,16,7,2,18,20,85,-20
"team",21900519,"WAS",1610612764,38,90,0.422,11,33,0.333333333333333,0.64,27,57,0.473684210526316,"Wizards","Washington",240,16,25,14,27,41,19,5,4,11,28,103,-19
"team",21900519,"POR",1610612757,45,88,0.511,6,25,0.24,0.788,39,63,0.619047619047619,"Trail Blazers","Portland",240,26,33,11,30,41,16,6,7,7,21,122,19
"team",21900520,"PHI",1610612755,42,92,0.457,6,27,0.222222222222222,0.72,36,65,0.553846153846154,"76ers","Philadelphia",240,18,25,10,34,44,32,7,6,11,22,108,-10
"team",21900520,"HOU",1610612745,41,86,0.477,12,32,0.375,0.75,29,54,0.537037037037037,"Rockets","Houston",240,24,32,8,38,46,22,6,3,11,24,118,10
"team",21900521,"PHX",1610612756,42,90,0.467,10,28,0.357142857142857,0.788,32,62,0.516129032258065,"Suns","Phoenix",240,26,33,9,39,48,28,7,3,10,25,120,8
"team",21900521,"NYK",1610612752,41,92,0.446,10,37,0.27027027027027,0.667,31,55,0.563636363636364,"Knicks","New York",240,20,30,13,39,52,19,7,7,15,26,112,-8
"team",21900522,"NOP",1610612740,48,102,0.471,11,37,0.297297297297297,0.857,37,65,0.569230769230769,"Pelicans","New Orleans",240,6,7,9,31,40,24,4,10,11,20,113,-10
"team",21900522,"LAL",1610612747,43,86,0.5,14,29,0.482758620689655,0.821,29,57,0.508771929824561,"Lakers","Los Angeles",240,23,28,8,39,47,29,9,4,12,14,123,10
"team",21900523,"MEM",1610612763,49,96,0.51,18,39,0.461538461538462,0.852,31,57,0.543859649122807,"Grizzlies","Memphis",240,23,27,11,43,54,36,8,10,9,23,139,26
"team",21900523,"LAC",1610612746,45,101,0.446,7,30,0.233333333333333,0.773,38,71,0.535211267605634,"Clippers","LA",240,17,22,14,35,49,20,3,1,13,22,114,-26
"team",21900524,"TOR",1610612761,44,97,0.454,13,32,0.40625,0.714,31,65,0.476923076923077,"Raptors","Toronto",240,20,28,15,28,43,21,10,4,7,25,121,19
"team",21900524,"BKN",1610612751,32,67,0.478,13,35,0.371428571428571,0.735,19,32,0.59375,"Nets","Brooklyn",240,25,34,6,32,38,24,4,11,24,24,102,-19
"team",21900525,"UTA",1610612762,42,93,0.452,16,40,0.4,0.643,26,53,0.490566037735849,"Jazz","Utah",240,9,14,14,37,51,22,3,3,8,10,109,13
"team",21900525,"ORL",1610612753,38,85,0.447,11,37,0.297297297297297,0.75,27,48,0.5625,"Magic","Orlando",240,9,12,9,37,46,21,6,5,10,12,96,-13
"team",21900526,"IND",1610612754,36,87,0.414,10,27,0.37037037037037,0.829,26,60,0.433333333333333,"Pacers","Indiana",240,29,35,13,26,39,24,8,4,11,24,111,-5
"team",21900526,"ATL",1610612737,42,82,0.512,10,32,0.3125,0.917,32,50,0.64,"Hawks","Atlanta",240,22,24,4,36,40,22,8,4,13,28,116,5
"team",21900527,"OKC",1610612760,43,96,0.448,14,37,0.378378378378378,0.808,29,59,0.491525423728814,"Thunder","Oklahoma City",240,21,26,18,34,52,24,6,4,11,16,121,15
"team",21900527,"CLE",1610612739,39,85,0.459,14,30,0.466666666666667,0.824,25,55,0.454545454545455,"Cavaliers","Cleveland",240,14,17,9,33,42,19,4,0,13,26,106,-15
"team",21900528,"WAS",1610612764,50,91,0.549,6,16,0.375,0.815,44,75,0.586666666666667,"Wizards","Washington",240,22,27,14,35,49,20,5,6,11,28,128,14
"team",21900528,"DEN",1610612743,40,87,0.46,6,29,0.206896551724138,0.824,34,58,0.586206896551724,"Nuggets","Denver",240,28,34,9,24,33,18,6,2,12,23,114,-14
"team",21900529,"CHI",1610612741,34,80,0.425,13,34,0.382352941176471,0.742,21,46,0.456521739130435,"Bulls","Chicago",240,23,31,11,26,37,23,15,5,15,22,104,-7
"team",21900529,"BOS",1610612738,43,82,0.524,8,19,0.421052631578947,0.81,35,63,0.555555555555556,"Celtics","Boston",240,17,21,13,31,44,22,10,5,19,22,111,7
"team",21900530,"DAL",1610612742,47,100,0.47,15,50,0.3,0.846,32,50,0.64,"Mavericks","Dallas",265,11,13,14,27,41,28,7,4,10,25,120,-3
"team",21900530,"CHA",1610612766,42,85,0.494,11,25,0.44,0.903,31,60,0.516666666666667,"Hornets","Charlotte",265,28,31,16,37,53,27,5,5,17,22,123,3
"team",21900531,"SAS",1610612759,38,92,0.413,11,32,0.34375,0.912,27,60,0.45,"Spurs","San Antonio",240,31,34,11,39,50,20,7,0,8,20,118,-9
"team",21900531,"MIL",1610612749,43,87,0.494,17,45,0.377777777777778,0.727,26,42,0.619047619047619,"Bucks","Milwaukee",240,24,33,7,42,49,23,4,10,9,22,127,9
"team",21900532,"GSW",1610612744,33,82,0.402,11,21,0.523809523809524,0.844,22,61,0.360655737704918,"Warriors","Golden State",240,27,32,11,31,42,26,13,3,14,19,104,-7
"team",21900532,"DET",1610612765,43,83,0.518,11,27,0.407407407407407,0.875,32,56,0.571428571428571,"Pistons","Detroit",240,14,16,9,37,46,24,13,5,21,25,111,7
"team",21900533,"SAC",1610612758,38,85,0.447,12,21,0.571428571428571,0.75,26,64,0.40625,"Kings","Sacramento",240,27,36,14,37,51,20,9,3,20,24,115,-2
"team",21900533,"NOP",1610612740,38,87,0.437,16,45,0.355555555555556,0.758,22,42,0.523809523809524,"Pelicans","New Orleans",240,25,33,9,35,44,28,11,3,15,25,117,2
"team",21900534,"NYK",1610612752,48,84,0.571,12,23,0.521739130434783,0.649,36,61,0.590163934426229,"Knicks","New York",240,24,37,8,29,37,22,11,4,16,26,132,-3
"team",21900534,"LAC",1610612746,45,83,0.542,18,32,0.5625,0.818,27,51,0.529411764705882,"Clippers","LA",240,27,33,10,32,42,25,4,3,19,27,135,3
"team",21900535,"POR",1610612757,40,87,0.46,13,37,0.351351351351351,0.9,27,50,0.54,"Trail Blazers","Portland",240,18,20,8,32,40,21,5,4,10,15,111,-11
"team",21900535,"MIA",1610612748,47,90,0.522,18,44,0.409090909090909,0.625,29,46,0.630434782608696,"Heat","Miami",240,10,16,11,36,47,34,4,5,10,17,122,11
"team",21900536,"MIN",1610612750,47,95,0.495,14,38,0.368421052631579,0.769,33,57,0.578947368421053,"Timberwolves","Minnesota",240,10,13,14,29,43,32,16,8,16,19,118,15
"team",21900536,"CLE",1610612739,40,84,0.476,8,25,0.32,0.789,32,59,0.542372881355932,"Cavaliers","Cleveland",240,15,19,12,32,44,15,6,2,20,13,103,-15
"team",21900537,"PHX",1610612756,43,95,0.453,6,26,0.230769230769231,0.846,37,69,0.536231884057971,"Suns","Phoenix",240,22,26,12,34,46,25,7,4,10,19,114,-7
"team",21900537,"MEM",1610612763,45,83,0.542,18,42,0.428571428571429,0.765,27,41,0.658536585365854,"Grizzlies","Memphis",240,13,17,3,39,42,31,4,8,16,22,121,7
"team",21900538,"LAL",1610612747,42,92,0.457,6,20,0.3,0.696,36,72,0.5,"Lakers","Los Angeles",240,16,23,11,39,50,23,8,20,13,22,106,7
"team",21900538,"DET",1610612765,29,78,0.372,11,26,0.423076923076923,0.857,18,52,0.346153846153846,"Pistons","Detroit",240,30,35,6,37,43,21,8,6,16,22,99,-7
"team",21900539,"IND",1610612754,47,89,0.528,10,26,0.384615384615385,0.786,37,63,0.587301587301587,"Pacers","Indiana",240,11,14,12,31,43,31,8,5,10,23,115,11
"team",21900539,"CHA",1610612766,37,81,0.457,10,30,0.333333333333333,0.909,27,51,0.529411764705882,"Hornets","Charlotte",240,20,22,8,30,38,21,3,3,11,14,104,-11
"team",21900540,"ORL",1610612753,35,81,0.432,8,26,0.307692307692308,0.742,27,55,0.490909090909091,"Magic","Orlando",240,23,31,11,49,60,21,8,3,18,19,101,12
"team",21900540,"BKN",1610612751,32,96,0.333,10,47,0.212765957446809,0.789,22,49,0.448979591836735,"Nets","Brooklyn",240,15,19,12,34,46,20,11,1,12,19,89,-12
"team",21900541,"PHI",1610612755,46,90,0.511,13,26,0.5,0.833,33,64,0.515625,"76ers","Philadelphia",240,15,18,9,33,42,31,4,0,10,28,120,7
"team",21900541,"OKC",1610612760,40,89,0.449,12,29,0.413793103448276,0.677,28,60,0.466666666666667,"Thunder","Oklahoma City",240,21,31,14,33,47,17,3,3,12,22,113,-7
"team",21900542,"WAS",1610612764,39,84,0.464,7,21,0.333333333333333,0.609,32,63,0.507936507936508,"Wizards","Washington",240,14,23,7,40,47,18,8,9,14,22,99,5
"team",21900542,"BOS",1610612738,33,95,0.347,8,37,0.216216216216216,0.769,25,58,0.431034482758621,"Celtics","Boston",240,20,26,16,39,55,17,7,8,16,20,94,-5
"team",21900543,"DEN",1610612743,47,92,0.511,9,27,0.333333333333333,0.741,38,65,0.584615384615385,"Nuggets","Denver",240,20,27,7,34,41,27,4,6,4,23,123,8
"team",21900543,"ATL",1610612737,35,77,0.455,18,39,0.461538461538462,0.844,17,38,0.447368421052632,"Hawks","Atlanta",240,27,32,4,30,34,24,3,5,10,22,115,-8
"team",21900544,"UTA",1610612762,46,90,0.511,16,33,0.484848484848485,0.833,30,57,0.526315789473684,"Jazz","Utah",240,20,24,7,36,43,19,3,3,8,25,128,2
"team",21900544,"NOP",1610612740,45,93,0.484,12,31,0.387096774193548,0.8,33,62,0.532258064516129,"Pelicans","New Orleans",240,24,30,12,35,47,23,4,5,6,20,126,-2
"team",21900545,"DAL",1610612742,44,84,0.524,16,41,0.390243902439024,0.737,28,43,0.651162790697674,"Mavericks","Dallas",240,14,19,11,32,43,25,5,6,14,12,118,8
"team",21900545,"CHI",1610612741,46,98,0.469,9,31,0.290322580645161,0.818,37,67,0.552238805970149,"Bulls","Chicago",240,9,11,17,28,45,25,10,7,8,21,110,-8
"team",21900546,"SAS",1610612759,45,88,0.511,19,35,0.542857142857143,0.895,26,53,0.490566037735849,"Spurs","San Antonio",240,17,19,10,44,54,23,4,2,11,16,126,22
"team",21900546,"MIL",1610612749,38,95,0.4,15,45,0.333333333333333,0.929,23,50,0.46,"Bucks","Milwaukee",240,13,14,10,28,38,24,5,5,8,15,104,-22
"team",21900547,"SAC",1610612758,39,81,0.481,15,30,0.5,0.783,24,51,0.470588235294118,"Kings","Sacramento",240,18,23,6,37,43,27,10,3,22,23,111,13
"team",21900547,"GSW",1610612744,34,86,0.395,5,26,0.192307692307692,0.781,29,60,0.483333333333333,"Warriors","Golden State",240,25,32,10,34,44,19,13,4,17,18,98,-13
"team",21900548,"DET",1610612765,42,91,0.462,13,33,0.393939393939394,0.857,29,58,0.5,"Pistons","Detroit",240,18,21,10,30,40,26,8,3,9,15,115,2
"team",21900548,"CLE",1610612739,42,85,0.494,14,31,0.451612903225806,0.938,28,54,0.518518518518518,"Cavaliers","Cleveland",240,15,16,11,35,46,29,7,4,16,19,113,-2
"team",21900549,"TOR",1610612761,35,96,0.365,15,42,0.357142857142857,0.737,20,54,0.37037037037037,"Raptors","Toronto",240,14,19,17,40,57,21,5,7,13,21,99,-2
"team",21900549,"POR",1610612757,38,88,0.432,13,35,0.371428571428571,0.857,25,53,0.471698113207547,"Trail Blazers","Portland",240,12,14,7,38,45,23,6,11,10,15,101,2
"team",21900550,"OKC",1610612760,38,92,0.413,11,37,0.297297297297297,0.828,27,55,0.490909090909091,"Thunder","Oklahoma City",265,24,29,8,43,51,19,11,3,15,15,111,8
"team",21900550,"BKN",1610612751,40,98,0.408,11,37,0.297297297297297,0.75,29,61,0.475409836065574,"Nets","Brooklyn",265,12,16,11,41,52,19,5,5,17,25,103,-8
"team",21900551,"MIN",1610612750,40,90,0.444,15,47,0.319148936170213,0.81,25,43,0.581395348837209,"Timberwolves","Minnesota",240,17,21,10,30,40,23,10,1,18,23,112,-7
"team",21900551,"MEM",1610612763,46,89,0.517,8,28,0.285714285714286,0.905,38,61,0.622950819672131,"Grizzlies","Memphis",240,19,21,9,35,44,22,12,6,15,18,119,7
"team",21900552,"SAC",1610612758,37,84,0.44,15,36,0.416666666666667,0.893,22,48,0.458333333333333,"Kings","Sacramento",240,25,28,8,33,41,18,8,1,15,22,114,11
"team",21900552,"PHX",1610612756,37,77,0.481,11,35,0.314285714285714,0.818,26,42,0.619047619047619,"Suns","Phoenix",240,18,22,6,35,41,24,4,2,17,25,103,-11
"team",21900553,"NYK",1610612752,37,95,0.389,4,20,0.2,0.563,33,75,0.44,"Knicks","New York",240,9,16,15,32,47,15,10,3,16,20,87,-30
"team",21900553,"LAL",1610612747,41,82,0.5,17,36,0.472222222222222,0.857,24,46,0.521739130434783,"Lakers","Los Angeles",240,18,21,6,42,48,27,11,11,17,19,117,30
"team",21900554,"SAS",1610612759,48,87,0.552,9,29,0.310344827586207,0.923,39,58,0.672413793103448,"Spurs","San Antonio",240,24,26,8,41,49,28,9,6,14,25,129,15
"team",21900554,"BOS",1610612738,37,89,0.416,13,38,0.342105263157895,0.9,24,51,0.470588235294118,"Celtics","Boston",240,27,30,8,31,39,26,7,2,15,20,114,-15
"team",21900555,"TOR",1610612761,42,94,0.447,14,36,0.388888888888889,0.7,28,58,0.482758620689655,"Raptors","Toronto",265,14,20,14,32,46,34,7,5,10,23,112,2
"team",21900555,"CHA",1610612766,38,86,0.442,15,37,0.405405405405405,0.731,23,49,0.469387755102041,"Hornets","Charlotte",265,19,26,13,37,50,30,6,6,17,21,110,-2
"team",21900556,"MIA",1610612748,43,81,0.531,16,38,0.421052631578947,0.8,27,43,0.627906976744186,"Heat","Miami",240,20,25,3,38,41,28,8,4,11,22,122,14
"team",21900556,"IND",1610612754,40,84,0.476,9,27,0.333333333333333,0.76,31,57,0.543859649122807,"Pacers","Indiana",240,19,25,6,31,37,25,5,3,12,18,108,-14
"team",21900557,"WAS",1610612764,36,84,0.429,6,23,0.260869565217391,0.579,30,61,0.491803278688525,"Wizards","Washington",240,11,19,10,30,40,24,8,5,23,22,89,-34
"team",21900557,"ORL",1610612753,43,87,0.494,10,27,0.37037037037037,0.794,33,60,0.55,"Magic","Orlando",240,27,34,13,38,51,24,18,3,16,21,123,34
"team",21900558,"HOU",1610612745,39,92,0.424,13,45,0.288888888888889,0.756,26,47,0.553191489361702,"Rockets","Houston",240,31,41,16,43,59,22,7,7,13,21,122,7
"team",21900558,"ATL",1610612737,39,106,0.368,13,44,0.295454545454545,0.889,26,62,0.419354838709677,"Hawks","Atlanta",240,24,27,16,38,54,20,6,8,11,29,115,-7
"team",21900559,"DEN",1610612743,41,85,0.482,9,24,0.375,0.8,32,61,0.524590163934426,"Nuggets","Denver",240,16,20,9,29,38,27,7,5,12,22,107,1
"team",21900559,"DAL",1610612742,39,77,0.506,12,35,0.342857142857143,0.667,27,42,0.642857142857143,"Mavericks","Dallas",240,16,24,6,32,38,27,8,6,13,18,106,-1
"team",21900560,"NOP",1610612740,41,87,0.471,15,44,0.340909090909091,0.813,26,43,0.604651162790698,"Pelicans","New Orleans",240,26,32,12,38,50,31,7,8,14,16,123,15
"team",21900560,"CHI",1610612741,41,92,0.446,14,35,0.4,0.571,27,57,0.473684210526316,"Bulls","Chicago",240,12,21,10,29,39,22,12,2,12,23,108,-15
"team",21900561,"UTA",1610612762,49,90,0.544,16,43,0.372093023255814,0.609,33,47,0.702127659574468,"Jazz","Utah",240,14,23,12,38,50,29,6,6,7,15,128,24
"team",21900561,"NYK",1610612752,42,97,0.433,9,25,0.36,1,33,72,0.458333333333333,"Knicks","New York",240,11,11,14,27,41,18,3,1,9,17,104,-24
"team",21900562,"MIL",1610612749,35,87,0.402,9,41,0.219512195121951,0.875,26,46,0.565217391304348,"Bucks","Milwaukee",240,28,32,5,42,47,22,11,3,9,19,107,9
"team",21900562,"GSW",1610612744,33,87,0.379,15,38,0.394736842105263,0.85,18,49,0.36734693877551,"Warriors","Golden State",240,17,20,12,40,52,29,7,4,18,30,98,-9
"team",21900563,"DET",1610612765,48,98,0.49,6,20,0.3,0.625,42,78,0.538461538461538,"Pistons","Detroit",265,10,16,19,27,46,20,8,9,15,25,112,-3
"team",21900563,"CLE",1610612739,48,91,0.527,5,20,0.25,0.7,43,71,0.605633802816901,"Cavaliers","Cleveland",265,14,20,10,29,39,24,9,5,14,18,115,3
"team",21900564,"PHI",1610612755,43,88,0.489,11,27,0.407407407407407,0.706,32,61,0.524590163934426,"76ers","Philadelphia",240,12,17,13,35,48,24,6,5,12,11,109,11
"team",21900564,"BOS",1610612738,38,88,0.432,14,36,0.388888888888889,1,24,52,0.461538461538462,"Celtics","Boston",240,8,8,8,30,38,17,8,1,14,16,98,-11
"team",21900565,"POR",1610612757,35,96,0.365,11,37,0.297297297297297,0.677,24,59,0.406779661016949,"Trail Blazers","Portland",240,21,31,14,27,41,14,9,6,10,21,102,-14
"team",21900565,"MIN",1610612750,44,89,0.494,13,32,0.40625,0.714,31,57,0.543859649122807,"Timberwolves","Minnesota",240,15,21,15,41,56,25,7,9,14,28,116,14
"team",21900566,"OKC",1610612760,43,87,0.494,11,32,0.34375,0.8,32,55,0.581818181818182,"Thunder","Oklahoma City",240,16,20,9,43,52,22,8,2,13,13,113,21
"team",21900566,"HOU",1610612745,34,89,0.382,11,40,0.275,0.929,23,49,0.469387755102041,"Rockets","Houston",240,13,14,8,31,39,16,4,3,14,21,92,-21
"team",21900567,"WAS",1610612764,42,112,0.375,10,29,0.344827586206897,0.607,32,83,0.385542168674699,"Wizards","Washington",240,17,28,19,38,57,26,11,1,9,22,111,10
"team",21900567,"ATL",1610612737,41,89,0.461,7,29,0.241379310344828,0.5,34,60,0.566666666666667,"Hawks","Atlanta",240,12,24,9,47,56,19,5,9,18,26,101,-10
"team",21900568,"MIA",1610612748,44,85,0.518,7,29,0.241379310344828,0.857,37,56,0.660714285714286,"Heat","Miami",240,18,21,4,36,40,26,6,3,7,20,113,-4
"team",21900568,"BKN",1610612751,45,93,0.484,15,44,0.340909090909091,0.632,30,49,0.612244897959184,"Nets","Brooklyn",240,12,19,14,37,51,31,5,4,9,15,117,4
"team",21900569,"NYK",1610612752,46,100,0.46,5,27,0.185185185185185,0.7,41,73,0.561643835616438,"Knicks","New York",240,14,20,14,32,46,26,13,1,13,16,111,-12
"team",21900569,"NOP",1610612740,48,86,0.558,18,38,0.473684210526316,0.529,30,48,0.625,"Pelicans","New Orleans",240,9,17,6,37,43,35,8,6,19,16,123,12
"team",21900570,"IND",1610612754,48,84,0.571,11,30,0.366666666666667,0.643,37,54,0.685185185185185,"Pacers","Indiana",240,9,14,8,38,46,31,9,5,11,16,116,11
"team",21900570,"CHI",1610612741,37,80,0.463,18,41,0.439024390243902,0.813,19,39,0.487179487179487,"Bulls","Chicago",240,13,16,6,30,36,16,6,3,15,15,105,-11
"team",21900571,"SAS",1610612759,42,87,0.483,17,40,0.425,0.87,25,47,0.531914893617021,"Spurs","San Antonio",240,20,23,5,32,37,29,3,6,11,17,121,-13
"team",21900571,"MEM",1610612763,52,100,0.52,16,38,0.421052631578947,0.875,36,62,0.580645161290323,"Grizzlies","Memphis",240,14,16,11,38,49,39,5,6,8,20,134,13
"team",21900572,"LAL",1610612747,47,89,0.528,10,24,0.416666666666667,0.781,37,65,0.569230769230769,"Lakers","Los Angeles",240,25,32,12,37,49,18,6,5,7,27,129,15
"team",21900572,"DAL",1610612742,39,96,0.406,11,38,0.289473684210526,0.676,28,58,0.482758620689655,"Mavericks","Dallas",240,25,37,17,30,47,19,4,3,9,20,114,-15
"team",21900573,"PHX",1610612756,33,79,0.418,9,28,0.321428571428571,0.885,24,51,0.470588235294118,"Suns","Phoenix",240,23,26,9,35,44,19,10,8,14,21,98,4
"team",21900573,"ORL",1610612753,33,89,0.371,9,33,0.272727272727273,0.792,24,56,0.428571428571429,"Magic","Orlando",240,19,24,14,35,49,15,9,6,14,23,94,-4
"team",21900574,"UTA",1610612762,40,79,0.506,18,42,0.428571428571429,0.786,22,37,0.594594594594595,"Jazz","Utah",240,11,14,9,31,40,28,9,6,15,20,109,17
"team",21900574,"CHA",1610612766,35,75,0.467,8,26,0.307692307692308,0.737,27,49,0.551020408163265,"Hornets","Charlotte",240,14,19,7,30,37,20,6,3,20,16,92,-17
"team",21900575,"SAC",1610612758,44,96,0.458,10,35,0.285714285714286,0.8,34,61,0.557377049180328,"Kings","Sacramento",240,8,10,6,39,45,26,8,3,16,24,106,-21
"team",21900575,"MIL",1610612749,47,95,0.495,10,39,0.256410256410256,0.767,37,56,0.660714285714286,"Bucks","Milwaukee",240,23,30,7,45,52,29,11,4,11,12,127,21
"team",21900576,"LAC",1610612746,41,84,0.488,11,39,0.282051282051282,0.727,30,45,0.666666666666667,"Clippers","LA",240,16,22,9,45,54,27,5,7,19,24,109,9
"team",21900576,"GSW",1610612744,37,96,0.385,8,39,0.205128205128205,0.72,29,57,0.508771929824561,"Warriors","Golden State",240,18,25,13,33,46,28,9,1,10,22,100,-9
"team",21900577,"MIN",1610612750,36,95,0.379,13,48,0.270833333333333,0.667,23,47,0.48936170212766,"Timberwolves","Minnesota",240,24,36,13,31,44,28,12,4,18,18,109,-30
"team",21900577,"HOU",1610612745,49,95,0.516,18,45,0.4,0.793,31,50,0.62,"Rockets","Houston",240,23,29,12,46,58,29,9,6,18,24,139,30
"team",21900578,"NOP",1610612740,40,100,0.4,14,45,0.311111111111111,0.611,26,55,0.472727272727273,"Pelicans","New Orleans",240,11,18,15,28,43,29,4,6,16,19,105,-35
"team",21900578,"BOS",1610612738,55,100,0.55,14,29,0.482758620689655,0.889,41,71,0.577464788732394,"Celtics","Boston",240,16,18,10,43,53,29,14,3,10,23,140,35
"team",21900579,"DET",1610612765,36,78,0.462,9,28,0.321428571428571,0.667,27,50,0.54,"Pistons","Detroit",240,18,27,12,30,42,22,7,4,19,20,99,-9
"team",21900579,"CHI",1610612741,42,83,0.506,11,35,0.314285714285714,0.929,31,48,0.645833333333333,"Bulls","Chicago",240,13,14,9,29,38,24,11,6,14,21,108,9
"team",21900580,"OKC",1610612760,43,92,0.467,9,31,0.290322580645161,0.882,34,61,0.557377049180328,"Thunder","Oklahoma City",240,15,17,5,32,37,23,6,6,7,13,110,-15
"team",21900580,"LAL",1610612747,51,99,0.515,15,32,0.46875,0.8,36,67,0.537313432835821,"Lakers","Los Angeles",240,8,10,12,42,54,21,3,4,12,17,125,15
"team",21900581,"PHI",1610612755,37,98,0.378,9,37,0.243243243243243,0.667,28,61,0.459016393442623,"76ers","Philadelphia",240,8,12,14,29,43,22,11,5,4,20,91,-18
"team",21900581,"DAL",1610612742,40,79,0.506,11,27,0.407407407407407,0.667,29,52,0.557692307692308,"Mavericks","Dallas",240,18,27,11,43,54,22,4,8,15,20,109,18
"team",21900582,"DEN",1610612743,41,95,0.432,8,39,0.205128205128205,0.722,33,56,0.589285714285714,"Nuggets","Denver",240,13,18,11,31,42,23,9,4,5,13,103,-8
"team",21900582,"CLE",1610612739,44,89,0.494,12,37,0.324324324324324,0.846,32,52,0.615384615384615,"Cavaliers","Cleveland",240,11,13,12,43,55,22,5,1,14,19,111,8
"team",21900583,"POR",1610612757,37,95,0.389,10,36,0.277777777777778,0.81,27,59,0.457627118644068,"Trail Blazers","Portland",240,17,21,8,40,48,17,6,4,13,20,101,-21
"team",21900583,"MIL",1610612749,47,103,0.456,14,38,0.368421052631579,0.7,33,65,0.507692307692308,"Bucks","Milwaukee",240,14,20,10,50,60,21,6,5,10,16,122,21
"team",21900584,"NYK",1610612752,46,90,0.511,9,31,0.290322580645161,0.821,37,59,0.627118644067797,"Knicks","New York",240,23,28,10,29,39,24,11,3,6,23,124,3
"team",21900584,"MIA",1610612748,42,78,0.538,14,35,0.4,0.821,28,43,0.651162790697674,"Heat","Miami",240,23,28,8,31,39,24,1,5,14,24,121,-3
"team",21900585,"WAS",1610612764,47,93,0.505,7,22,0.318181818181818,0.882,40,71,0.563380281690141,"Wizards","Washington",240,15,17,9,28,37,28,5,4,9,18,116,-11
"team",21900585,"UTA",1610612762,48,90,0.533,10,30,0.333333333333333,0.84,38,60,0.633333333333333,"Jazz","Utah",240,21,25,12,32,44,24,6,2,11,18,127,11
"team",21900586,"BKN",1610612751,41,77,0.532,10,26,0.384615384615385,0.552,31,51,0.607843137254902,"Nets","Brooklyn",240,16,29,7,55,62,25,8,2,24,20,108,22
"team",21900586,"ATL",1610612737,32,97,0.33,12,48,0.25,0.909,20,49,0.408163265306122,"Hawks","Atlanta",240,10,11,4,29,33,23,16,4,12,23,86,-22
"team",21900587,"TOR",1610612761,39,96,0.406,17,48,0.354166666666667,0.818,22,48,0.458333333333333,"Raptors","Toronto",240,9,11,8,37,45,30,7,3,11,23,104,-1
"team",21900587,"SAS",1610612759,38,87,0.437,7,32,0.21875,0.733,31,55,0.563636363636364,"Spurs","San Antonio",240,22,30,9,42,51,24,6,5,11,11,105,1
"team",21900588,"MEM",1610612763,45,100,0.45,11,35,0.314285714285714,0.84,34,65,0.523076923076923,"Grizzlies","Memphis",240,21,25,18,42,60,33,17,7,16,16,122,20
"team",21900588,"GSW",1610612744,35,92,0.38,17,34,0.5,0.714,18,58,0.310344827586207,"Warriors","Golden State",240,15,21,12,35,47,23,11,6,22,18,102,-20
"team",21900589,"LAC",1610612746,38,84,0.452,8,33,0.242424242424242,0.769,30,51,0.588235294117647,"Clippers","LA",240,20,26,10,32,42,21,8,5,14,26,104,-10
"team",21900589,"DEN",1610612743,37,77,0.481,11,25,0.44,0.784,26,52,0.5,"Nuggets","Denver",240,29,37,9,35,44,24,7,4,13,26,114,10
"team",21900590,"PHX",1610612756,41,82,0.5,7,21,0.333333333333333,0.611,34,61,0.557377049180328,"Suns","Phoenix",240,11,18,12,39,51,22,8,5,18,19,100,8
"team",21900590,"CHA",1610612766,36,86,0.419,8,35,0.228571428571429,0.667,28,51,0.549019607843137,"Hornets","Charlotte",240,12,18,8,29,37,25,10,3,14,19,92,-8
"team",21900591,"NOP",1610612740,43,103,0.417,9,26,0.346153846153846,0.815,34,77,0.441558441558442,"Pelicans","New Orleans",265,22,27,17,44,61,23,6,5,19,19,117,7
"team",21900591,"DET",1610612765,40,99,0.404,11,32,0.34375,0.792,29,67,0.432835820895522,"Pistons","Detroit",265,19,24,5,38,43,27,11,8,9,25,110,-7
"team",21900592,"PHI",1610612755,37,89,0.416,6,33,0.181818181818182,0.789,31,56,0.553571428571429,"76ers","Philadelphia",240,15,19,12,40,52,17,6,4,11,21,95,-6
"team",21900592,"IND",1610612754,33,86,0.384,10,26,0.384615384615385,0.806,23,60,0.383333333333333,"Pacers","Indiana",240,25,31,13,37,50,24,6,6,9,14,101,6
"team",21900593,"CHI",1610612741,37,81,0.457,6,25,0.24,0.808,31,56,0.553571428571429,"Bulls","Chicago",240,21,26,7,31,38,16,5,5,14,22,101,-12
"team",21900593,"BOS",1610612738,39,83,0.47,9,23,0.391304347826087,0.897,30,60,0.5,"Celtics","Boston",240,26,29,10,33,43,28,7,6,12,19,113,12
"team",21900594,"OKC",1610612760,41,82,0.5,12,30,0.4,0.885,29,52,0.557692307692308,"Thunder","Oklahoma City",240,23,26,7,44,51,25,4,6,15,16,117,13
"team",21900594,"MIN",1610612750,38,91,0.418,12,35,0.342857142857143,0.762,26,56,0.464285714285714,"Timberwolves","Minnesota",240,16,21,9,28,37,23,10,6,9,21,104,-13
"team",21900595,"POR",1610612757,42,83,0.506,16,37,0.432432432432432,0.789,26,46,0.565217391304348,"Trail Blazers","Portland",240,15,19,9,38,47,26,4,5,13,21,115,3
"team",21900595,"CHA",1610612766,40,90,0.444,18,38,0.473684210526316,0.778,22,52,0.423076923076923,"Hornets","Charlotte",240,14,18,10,32,42,24,7,3,8,20,112,-3
"team",21900596,"SAC",1610612758,45,87,0.517,12,31,0.387096774193548,0.909,33,56,0.589285714285714,"Kings","Sacramento",240,10,11,4,40,44,25,6,4,12,21,112,-2
"team",21900596,"ORL",1610612753,40,92,0.435,9,29,0.310344827586207,0.833,31,63,0.492063492063492,"Magic","Orlando",240,25,30,12,34,46,17,6,5,8,12,114,2
"team",21900597,"LAL",1610612747,48,88,0.545,11,30,0.366666666666667,0.75,37,58,0.637931034482759,"Lakers","Los Angeles",240,21,28,11,34,45,33,8,3,9,25,128,29
"team",21900597,"CLE",1610612739,38,85,0.447,7,25,0.28,0.667,31,60,0.516666666666667,"Cavaliers","Cleveland",240,16,24,10,30,40,21,4,1,19,22,99,-29
"team",21900598,"PHX",1610612756,40,87,0.46,4,20,0.2,0.813,36,67,0.537313432835821,"Suns","Phoenix",240,26,32,10,30,40,20,9,6,11,19,110,-13
"team",21900598,"ATL",1610612737,46,93,0.495,14,31,0.451612903225806,0.85,32,62,0.516129032258065,"Hawks","Atlanta",240,17,20,12,34,46,25,3,10,15,25,123,13
"team",21900599,"UTA",1610612762,46,92,0.5,13,36,0.361111111111111,0.867,33,56,0.589285714285714,"Jazz","Utah",240,13,15,7,34,41,19,8,3,8,15,118,11
"team",21900599,"BKN",1610612751,45,90,0.5,8,26,0.307692307692308,0.6,37,64,0.578125,"Nets","Brooklyn",240,9,15,11,32,43,22,4,4,12,13,107,-11
"team",21900600,"MEM",1610612763,46,91,0.505,13,37,0.351351351351351,0.842,33,54,0.611111111111111,"Grizzlies","Memphis",240,16,19,7,35,42,29,6,9,7,19,121,11
"team",21900600,"HOU",1610612745,37,86,0.43,14,45,0.311111111111111,0.917,23,41,0.560975609756098,"Rockets","Houston",240,22,24,9,32,41,18,4,2,15,23,110,-11
"team",21900601,"NYK",1610612752,36,102,0.353,11,37,0.297297297297297,0.731,25,65,0.384615384615385,"Knicks","New York",240,19,26,12,37,49,26,7,3,11,21,102,-26
"team",21900601,"MIL",1610612749,45,92,0.489,15,36,0.416666666666667,0.821,30,56,0.535714285714286,"Bucks","Milwaukee",240,23,28,8,51,59,27,4,8,14,22,128,26
"team",21900602,"GSW",1610612744,39,87,0.448,9,32,0.28125,0.769,30,55,0.545454545454545,"Warriors","Golden State",240,10,13,7,29,36,27,4,1,14,16,97,-27
"team",21900602,"DAL",1610612742,49,96,0.51,13,37,0.351351351351351,0.619,36,59,0.610169491525424,"Mavericks","Dallas",240,13,21,15,38,53,23,5,2,7,17,124,27
"team",21900603,"LAC",1610612746,49,94,0.521,15,38,0.394736842105263,0.714,34,56,0.607142857142857,"Clippers","LA",240,15,21,14,39,53,29,7,8,11,12,128,25
"team",21900603,"CLE",1610612739,38,91,0.418,14,37,0.378378378378378,0.867,24,54,0.444444444444444,"Cavaliers","Cleveland",240,13,15,8,32,40,25,5,6,13,21,103,-25
"team",21900604,"DET",1610612765,47,78,0.603,12,32,0.375,0.526,35,46,0.760869565217391,"Pistons","Detroit",240,10,19,3,31,34,30,8,4,11,19,116,13
"team",21900604,"BOS",1610612738,41,83,0.494,9,28,0.321428571428571,0.6,32,55,0.581818181818182,"Celtics","Boston",240,12,20,13,31,44,21,7,2,15,17,103,-13
"team",21900605,"PHI",1610612755,45,88,0.511,11,30,0.366666666666667,0.64,34,58,0.586206896551724,"76ers","Philadelphia",240,16,25,13,36,49,25,7,11,12,23,117,11
"team",21900605,"BKN",1610612751,38,87,0.437,12,25,0.48,0.6,26,62,0.419354838709677,"Nets","Brooklyn",240,18,30,11,33,44,20,9,1,13,22,106,-11
"team",21900606,"SAS",1610612759,39,89,0.438,10,33,0.303030303030303,0.8,29,56,0.517857142857143,"Spurs","San Antonio",240,12,15,6,35,41,22,8,4,8,17,100,-6
"team",21900606,"MIA",1610612748,41,88,0.466,17,40,0.425,0.538,24,48,0.5,"Heat","Miami",240,7,13,8,41,49,26,4,5,9,14,106,6
"team",21900607,"WAS",1610612764,37,79,0.468,11,27,0.407407407407407,0.808,26,52,0.5,"Wizards","Washington",240,21,26,7,31,38,25,8,6,16,17,106,-9
"team",21900607,"CHI",1610612741,43,85,0.506,14,38,0.368421052631579,0.682,29,47,0.617021276595745,"Bulls","Chicago",240,15,22,8,33,41,26,11,5,15,19,115,9
"team",21900608,"MIN",1610612750,38,88,0.432,11,28,0.392857142857143,0.75,27,60,0.45,"Timberwolves","Minnesota",240,12,16,10,35,45,26,6,7,15,14,99,-5
"team",21900608,"IND",1610612754,44,85,0.518,7,23,0.304347826086957,0.75,37,62,0.596774193548387,"Pacers","Indiana",240,9,12,7,38,45,27,7,3,15,15,104,5
"team",21900609,"TOR",1610612761,52,85,0.612,15,27,0.555555555555556,0.733,37,58,0.637931034482759,"Raptors","Toronto",240,11,15,5,31,36,33,13,1,18,23,130,9
"team",21900609,"OKC",1610612760,43,85,0.506,16,42,0.380952380952381,0.95,27,43,0.627906976744186,"Thunder","Oklahoma City",240,19,20,4,27,31,32,14,3,18,17,121,-9
"team",21900610,"DEN",1610612743,38,79,0.481,9,28,0.321428571428571,0.6,29,51,0.568627450980392,"Nuggets","Denver",240,15,25,3,37,40,28,8,7,11,18,100,14
"team",21900610,"CHA",1610612766,33,81,0.407,12,35,0.342857142857143,0.571,21,46,0.456521739130435,"Hornets","Charlotte",240,8,14,9,33,42,28,4,6,14,24,86,-14
"team",21900611,"POR",1610612757,41,95,0.432,11,36,0.305555555555556,0.828,30,59,0.508474576271186,"Trail Blazers","Portland",240,24,29,12,46,58,22,6,4,7,19,117,10
"team",21900611,"HOU",1610612745,38,96,0.396,16,49,0.326530612244898,0.652,22,47,0.468085106382979,"Rockets","Houston",240,15,23,12,38,50,24,4,4,12,22,107,-10
"team",21900612,"SAC",1610612758,50,96,0.521,12,33,0.363636363636364,0.55,38,63,0.603174603174603,"Kings","Sacramento",240,11,20,11,31,42,28,5,0,8,22,123,-4
"team",21900612,"DAL",1610612742,47,92,0.511,13,40,0.325,0.833,34,52,0.653846153846154,"Mavericks","Dallas",240,20,24,13,34,47,24,4,2,11,18,127,4
"team",21900613,"ORL",1610612753,43,94,0.457,10,26,0.384615384615385,0.793,33,68,0.485294117647059,"Magic","Orlando",240,23,29,13,35,48,22,10,2,13,15,119,1
"team",21900613,"LAL",1610612747,48,97,0.495,15,38,0.394736842105263,0.636,33,59,0.559322033898305,"Lakers","Los Angeles",240,7,11,13,35,48,34,7,6,16,20,118,-1
"team",21900614,"PHX",1610612756,47,92,0.511,12,30,0.4,0.833,35,62,0.564516129032258,"Suns","Phoenix",240,15,18,14,39,53,31,11,4,18,22,121,23
"team",21900614,"NYK",1610612752,37,90,0.411,8,26,0.307692307692308,0.667,29,64,0.453125,"Knicks","New York",240,16,24,10,30,40,21,11,3,18,21,98,-23
"team",21900615,"MIL",1610612749,43,87,0.494,16,31,0.516129032258065,0.703,27,56,0.482142857142857,"Bucks","Milwaukee",240,26,37,7,43,50,21,6,6,10,22,128,5
"team",21900615,"BOS",1610612738,43,98,0.439,15,49,0.306122448979592,0.815,28,49,0.571428571428571,"Celtics","Boston",240,22,27,10,33,43,16,4,7,7,25,123,-5
"team",21900616,"UTA",1610612762,46,100,0.46,15,39,0.384615384615385,0.781,31,61,0.508196721311475,"Jazz","Utah",265,25,32,11,32,43,23,9,6,13,29,132,-6
"team",21900616,"NOP",1610612740,51,93,0.548,11,26,0.423076923076923,0.714,40,67,0.597014925373134,"Pelicans","New Orleans",265,25,35,9,36,45,29,8,9,13,27,138,6
"team",21900617,"GSW",1610612744,42,95,0.442,20,45,0.444444444444444,0.871,22,50,0.44,"Warriors","Golden State",265,27,31,11,32,43,36,11,6,18,20,131,-3
"team",21900617,"DEN",1610612743,47,100,0.47,17,35,0.485714285714286,0.885,30,65,0.461538461538462,"Nuggets","Denver",265,23,26,15,40,55,31,11,6,19,23,134,3
"team",21900618,"ORL",1610612753,36,92,0.391,14,42,0.333333333333333,0.563,22,50,0.44,"Magic","Orlando",240,9,16,6,36,42,24,4,4,9,21,95,-27
"team",21900618,"LAC",1610612746,47,95,0.495,14,32,0.4375,0.7,33,63,0.523809523809524,"Clippers","LA",240,14,20,10,49,59,29,4,4,9,17,122,27
"team",21900619,"MIN",1610612750,40,88,0.455,17,39,0.435897435897436,0.81,23,49,0.469387755102041,"Timberwolves","Minnesota",240,17,21,7,29,36,22,4,1,13,19,114,-2
"team",21900619,"IND",1610612754,46,82,0.561,8,24,0.333333333333333,0.8,38,58,0.655172413793103,"Pacers","Indiana",240,16,20,4,37,41,24,4,8,13,20,116,2
"team",21900620,"PHI",1610612755,40,82,0.488,9,29,0.310344827586207,1,31,53,0.584905660377358,"76ers","Philadelphia",240,11,11,9,35,44,30,9,7,11,12,100,11
"team",21900620,"CHI",1610612741,35,81,0.432,8,35,0.228571428571429,0.733,27,46,0.58695652173913,"Bulls","Chicago",240,11,15,6,31,37,21,8,3,16,14,89,-11
"team",21900621,"WAS",1610612764,40,89,0.449,15,35,0.428571428571429,0.696,25,54,0.462962962962963,"Wizards","Washington",240,16,23,13,30,43,19,9,3,26,16,111,-29
"team",21900621,"TOR",1610612761,52,91,0.571,22,43,0.511627906976744,0.875,30,48,0.625,"Raptors","Toronto",240,14,16,7,34,41,35,16,2,19,24,140,29
"team",21900622,"MEM",1610612763,45,89,0.506,9,28,0.321428571428571,0.7,36,61,0.590163934426229,"Grizzlies","Memphis",240,14,20,7,37,44,32,11,8,12,19,113,4
"team",21900622,"CLE",1610612739,41,92,0.446,9,36,0.25,0.692,32,56,0.571428571428571,"Cavaliers","Cleveland",240,18,26,16,34,50,18,6,2,15,19,109,-4
"team",21900623,"OKC",1610612760,37,84,0.44,18,46,0.391304347826087,0.889,19,38,0.5,"Thunder","Oklahoma City",240,16,18,6,29,35,29,4,5,10,20,108,-7
"team",21900623,"MIA",1610612748,41,84,0.488,14,36,0.388888888888889,0.792,27,48,0.5625,"Heat","Miami",240,19,24,6,39,45,26,4,3,11,23,115,7
"team",21900624,"SAS",1610612759,45,98,0.459,8,29,0.275862068965517,0.957,37,69,0.536231884057971,"Spurs","San Antonio",240,22,23,14,34,48,28,12,6,15,27,120,-1
"team",21900624,"ATL",1610612737,41,82,0.5,19,40,0.475,0.741,22,42,0.523809523809524,"Hawks","Atlanta",240,20,27,8,35,43,21,10,6,19,18,121,1
"team",21900625,"POR",1610612757,44,85,0.518,9,30,0.3,0.682,35,55,0.636363636363636,"Trail Blazers","Portland",240,15,22,8,32,40,25,6,5,12,22,112,-8
"team",21900625,"DAL",1610612742,39,89,0.438,20,47,0.425531914893617,0.786,19,42,0.452380952380952,"Mavericks","Dallas",240,22,28,13,30,43,19,6,4,13,17,120,8
"team",21900626,"NOP",1610612740,46,86,0.535,15,41,0.365853658536585,0.639,31,45,0.688888888888889,"Pelicans","New Orleans",240,23,36,12,36,48,32,7,4,21,26,130,-3
"team",21900626,"LAC",1610612746,46,93,0.495,10,31,0.32258064516129,0.795,36,62,0.580645161290323,"Clippers","LA",240,31,39,10,26,36,22,12,2,12,29,133,3
"team",21900627,"MIL",1610612749,45,89,0.506,17,37,0.459459459459459,0.625,28,52,0.538461538461538,"Bucks","Milwaukee",240,10,16,5,49,54,30,8,6,20,16,117,20
"team",21900627,"BKN",1610612751,33,99,0.333,15,49,0.306122448979592,0.941,18,50,0.36,"Nets","Brooklyn",240,16,17,12,35,47,23,11,7,17,19,97,-20
"team",21900628,"PHX",1610612756,42,89,0.472,13,31,0.419354838709677,0.867,29,58,0.5,"Suns","Phoenix",240,26,30,10,42,52,27,6,6,15,16,123,4
"team",21900628,"BOS",1610612738,42,96,0.438,15,42,0.357142857142857,0.909,27,54,0.5,"Celtics","Boston",240,20,22,4,35,39,26,11,6,11,24,119,-4
"team",21900629,"DET",1610612765,51,86,0.593,15,32,0.46875,0.76,36,54,0.666666666666667,"Pistons","Detroit",240,19,25,11,30,41,31,12,8,17,18,136,33
"team",21900629,"ATL",1610612737,40,93,0.43,10,34,0.294117647058824,0.867,30,59,0.508474576271186,"Hawks","Atlanta",240,13,15,10,22,32,18,9,6,19,20,103,-33
"team",21900630,"PHI",1610612755,34,78,0.436,10,32,0.3125,0.632,24,46,0.521739130434783,"76ers","Philadelphia",240,12,19,5,36,41,26,8,6,13,19,90,3
"team",21900630,"NYK",1610612752,35,88,0.398,6,25,0.24,0.611,29,63,0.46031746031746,"Knicks","New York",240,11,18,12,36,48,20,4,5,14,18,87,-3
"team",21900631,"CLE",1610612739,40,73,0.548,15,29,0.517241379310345,0.913,25,44,0.568181818181818,"Cavaliers","Cleveland",240,21,23,7,29,36,27,5,5,27,18,116,-2
"team",21900631,"CHI",1610612741,48,87,0.552,9,25,0.36,0.765,39,62,0.629032258064516,"Bulls","Chicago",240,13,17,4,22,26,25,18,4,12,24,118,2
"team",21900632,"TOR",1610612761,47,91,0.516,13,35,0.371428571428571,0.882,34,56,0.607142857142857,"Raptors","Toronto",240,15,17,7,35,42,25,13,9,14,23,122,10
"team",21900632,"MIN",1610612750,38,94,0.404,14,50,0.28,0.815,24,44,0.545454545454545,"Timberwolves","Minnesota",240,22,27,12,37,49,34,8,5,17,18,112,-10
"team",21900633,"LAL",1610612747,45,93,0.484,11,33,0.333333333333333,0.719,34,60,0.566666666666667,"Lakers","Los Angeles",240,23,32,15,34,49,25,13,9,17,27,124,9
"team",21900633,"HOU",1610612745,40,90,0.444,12,37,0.324324324324324,0.793,28,53,0.528301886792453,"Rockets","Houston",240,23,29,11,35,46,20,8,4,20,26,115,-9
"team",21900634,"ORL",1610612753,39,86,0.453,9,31,0.290322580645161,0.615,30,55,0.545454545454545,"Magic","Orlando",240,8,13,9,37,46,21,7,5,15,12,95,-14
"team",21900634,"GSW",1610612744,43,94,0.457,12,40,0.3,1,31,54,0.574074074074074,"Warriors","Golden State",240,11,11,7,37,44,25,9,2,10,13,109,14
"team",21900635,"POR",1610612757,39,91,0.429,12,32,0.375,0.762,27,59,0.457627118644068,"Trail Blazers","Portland",240,16,21,12,28,40,11,7,7,12,28,106,-13
"team",21900635,"OKC",1610612760,43,83,0.518,7,22,0.318181818181818,0.722,36,61,0.590163934426229,"Thunder","Oklahoma City",240,26,36,12,36,48,25,5,4,12,20,119,13
"team",21900636,"UTA",1610612762,43,85,0.506,14,42,0.333333333333333,0.958,29,43,0.674418604651163,"Jazz","Utah",240,23,24,10,37,47,24,7,4,8,14,123,22
"team",21900636,"SAC",1610612758,42,86,0.488,10,26,0.384615384615385,0.583,32,60,0.533333333333333,"Kings","Sacramento",240,7,12,7,30,37,20,3,3,10,23,101,-22
"team",21900637,"SAS",1610612759,36,85,0.424,12,33,0.363636363636364,0.958,24,52,0.461538461538462,"Spurs","San Antonio",240,23,24,9,34,43,27,5,4,11,18,107,5
"team",21900637,"MIA",1610612748,37,86,0.43,10,34,0.294117647058824,0.9,27,52,0.519230769230769,"Heat","Miami",240,18,20,10,37,47,23,8,3,9,19,102,-5
"team",21900638,"IND",1610612754,43,86,0.5,13,29,0.448275862068966,0.842,30,57,0.526315789473684,"Pacers","Indiana",240,16,19,11,27,38,31,1,4,14,25,115,8
"team",21900638,"DEN",1610612743,41,88,0.466,3,23,0.130434782608696,0.688,38,65,0.584615384615385,"Nuggets","Denver",240,22,32,12,32,44,22,10,4,9,19,107,-8
"team",21900639,"WAS",1610612764,42,82,0.512,9,24,0.375,0.813,33,58,0.568965517241379,"Wizards","Washington",240,13,16,6,38,44,22,9,6,19,23,106,6
"team",21900639,"DET",1610612765,38,89,0.427,10,32,0.3125,0.7,28,57,0.491228070175439,"Pistons","Detroit",240,14,20,11,30,41,19,10,5,17,18,100,-6
"team",21900640,"TOR",1610612761,38,92,0.413,13,42,0.30952380952381,0.767,25,50,0.5,"Raptors","Toronto",240,33,43,12,33,45,25,13,3,14,25,122,5
"team",21900640,"ATL",1610612737,41,83,0.494,12,33,0.363636363636364,0.697,29,50,0.58,"Hawks","Atlanta",240,23,33,9,41,50,26,9,8,23,34,117,-5
"team",21900641,"PHI",1610612755,42,94,0.447,13,39,0.333333333333333,0.741,29,55,0.527272727272727,"76ers","Philadelphia",240,20,27,12,31,43,30,12,6,12,24,117,6
"team",21900641,"BKN",1610612751,39,81,0.481,11,29,0.379310344827586,0.647,28,52,0.538461538461538,"Nets","Brooklyn",240,22,34,13,34,47,22,7,2,22,23,111,-6
"team",21900642,"ORL",1610612753,44,92,0.478,14,28,0.5,0.444,30,64,0.46875,"Magic","Orlando",240,4,9,15,32,47,25,9,4,9,15,106,23
"team",21900642,"CHA",1610612766,29,76,0.382,10,33,0.303030303030303,0.75,19,43,0.441860465116279,"Hornets","Charlotte",240,15,20,9,30,39,21,4,5,18,18,83,-23
"team",21900643,"NYK",1610612752,41,85,0.482,9,23,0.391304347826087,0.882,32,62,0.516129032258065,"Knicks","New York",240,15,17,7,42,49,17,6,9,10,17,106,20
"team",21900643,"CLE",1610612739,32,94,0.34,11,33,0.333333333333333,0.647,21,61,0.344262295081967,"Cavaliers","Cleveland",240,11,17,16,37,53,15,5,4,10,14,86,-20
"team",21900644,"SAC",1610612758,44,106,0.415,13,51,0.254901960784314,0.8,31,55,0.563636363636364,"Kings","Sacramento",265,12,15,16,33,49,27,11,3,15,21,113,-5
"team",21900644,"MIA",1610612748,42,83,0.506,16,42,0.380952380952381,0.818,26,41,0.634146341463415,"Heat","Miami",265,18,22,5,37,42,26,9,3,21,20,118,5
"team",21900645,"OKC",1610612760,40,92,0.435,12,32,0.375,0.769,28,60,0.466666666666667,"Thunder","Oklahoma City",240,20,26,7,40,47,14,8,6,12,18,112,5
"team",21900645,"HOU",1610612745,43,97,0.443,9,45,0.2,0.706,34,52,0.653846153846154,"Rockets","Houston",240,12,17,9,34,43,21,6,7,11,23,107,-5
"team",21900646,"NOP",1610612740,42,88,0.477,21,48,0.4375,0.875,21,40,0.525,"Pelicans","New Orleans",240,21,24,5,38,43,24,7,7,16,18,126,10
"team",21900646,"MEM",1610612763,46,103,0.447,9,33,0.272727272727273,0.714,37,70,0.528571428571429,"Grizzlies","Memphis",240,15,21,15,36,51,26,8,3,14,19,116,-10
"team",21900647,"MIL",1610612749,45,77,0.584,11,26,0.423076923076923,0.435,34,51,0.666666666666667,"Bucks","Milwaukee",240,10,23,3,45,48,34,7,5,23,15,111,13
"team",21900647,"CHI",1610612741,34,92,0.37,14,48,0.291666666666667,0.889,20,44,0.454545454545455,"Bulls","Chicago",240,16,18,7,32,39,18,11,2,16,21,98,-13
"team",21900648,"LAL",1610612747,39,89,0.438,7,26,0.269230769230769,0.759,32,63,0.507936507936508,"Lakers","Los Angeles",240,22,29,12,24,36,22,5,8,15,23,107,-32
"team",21900648,"BOS",1610612738,52,93,0.559,16,34,0.470588235294118,0.655,36,59,0.610169491525424,"Celtics","Boston",240,19,29,14,34,48,31,10,5,12,26,139,32
"team",21900649,"MIN",1610612750,38,91,0.418,13,42,0.30952380952381,0.786,25,49,0.510204081632653,"Timberwolves","Minnesota",240,11,14,11,31,42,26,7,5,9,11,100,-7
"team",21900649,"DEN",1610612743,43,90,0.478,11,31,0.354838709677419,0.833,32,59,0.542372881355932,"Nuggets","Denver",240,10,12,13,40,53,26,9,1,13,18,107,7
"team",21900650,"SAS",1610612759,43,87,0.494,17,31,0.548387096774194,0.773,26,56,0.464285714285714,"Spurs","San Antonio",240,17,22,6,25,31,30,12,7,8,23,120,2
"team",21900650,"PHX",1610612756,42,80,0.525,8,22,0.363636363636364,0.867,34,58,0.586206896551724,"Suns","Phoenix",240,26,30,8,35,43,26,3,3,14,19,118,-2
"team",21900651,"UTA",1610612762,47,87,0.54,12,31,0.387096774193548,1,35,56,0.625,"Jazz","Utah",240,12,12,11,42,53,22,5,4,21,11,118,30
"team",21900651,"IND",1610612754,39,93,0.419,7,26,0.269230769230769,0.429,32,67,0.477611940298507,"Pacers","Indiana",240,3,7,9,21,30,23,15,9,13,14,88,-30
"team",21900652,"POR",1610612757,44,100,0.44,14,44,0.318181818181818,0.9,30,56,0.535714285714286,"Trail Blazers","Portland",265,27,30,12,42,54,21,4,11,12,19,129,5
"team",21900652,"GSW",1610612744,48,116,0.414,9,36,0.25,0.864,39,80,0.4875,"Warriors","Golden State",265,19,22,19,41,60,30,7,5,9,25,124,-5
"team",21900653,"LAC",1610612746,36,97,0.371,12,38,0.315789473684211,0.788,24,59,0.406779661016949,"Clippers","LA",240,26,33,20,37,57,19,9,3,10,21,110,3
"team",21900653,"DAL",1610612742,39,91,0.429,12,43,0.27906976744186,0.708,27,48,0.5625,"Mavericks","Dallas",240,17,24,12,37,49,23,7,8,12,28,107,-3
"team",21900654,"SAC",1610612758,42,98,0.429,10,35,0.285714285714286,0.522,32,63,0.507936507936508,"Kings","Sacramento",240,12,23,12,33,45,23,10,1,10,28,106,-21
"team",21900654,"DET",1610612765,39,73,0.534,12,29,0.413793103448276,0.841,27,44,0.613636363636364,"Pistons","Detroit",240,37,44,3,45,48,19,9,4,17,19,127,21
"team",21900655,"ORL",1610612753,44,92,0.478,14,35,0.4,0.75,30,57,0.526315789473684,"Magic","Orlando",240,12,16,11,28,39,26,9,3,14,25,114,-6
"team",21900655,"OKC",1610612760,46,76,0.605,9,19,0.473684210526316,0.826,37,57,0.649122807017544,"Thunder","Oklahoma City",240,19,23,0,36,36,22,10,7,15,17,120,6
"team",21900656,"LAC",1610612746,33,78,0.423,4,21,0.19047619047619,0.641,29,57,0.508771929824561,"Clippers","LA",240,25,39,8,37,45,19,5,8,14,20,95,-7
"team",21900656,"ATL",1610612737,36,102,0.353,11,35,0.314285714285714,0.826,25,67,0.373134328358209,"Hawks","Atlanta",240,19,23,23,40,63,21,8,3,15,31,102,7
"team",21900657,"MEM",1610612763,36,85,0.424,11,32,0.34375,0.8,25,53,0.471698113207547,"Grizzlies","Memphis",240,12,15,5,35,40,24,7,8,16,16,95,-24
"team",21900657,"BOS",1610612738,45,89,0.506,14,32,0.4375,0.75,31,57,0.543859649122807,"Celtics","Boston",240,15,20,9,35,44,32,11,9,9,14,119,24
"team",21900658,"WAS",1610612764,50,99,0.505,13,42,0.30952380952381,0.8,37,57,0.649122807017544,"Wizards","Washington",265,16,20,7,34,41,30,10,5,11,29,129,-5
"team",21900658,"MIA",1610612748,43,85,0.506,17,33,0.515151515151515,0.861,26,52,0.5,"Heat","Miami",265,31,36,6,37,43,29,3,6,16,18,134,5
"team",21900659,"NYK",1610612752,36,88,0.409,11,34,0.323529411764706,0.692,25,54,0.462962962962963,"Knicks","New York",240,9,13,13,34,47,24,4,4,17,23,92,-8
"team",21900659,"LAL",1610612747,36,82,0.439,9,27,0.333333333333333,0.679,27,55,0.490909090909091,"Lakers","Los Angeles",240,19,28,11,32,43,18,13,8,10,14,100,8
"team",21900660,"TOR",1610612761,40,86,0.465,13,33,0.393939393939394,0.667,27,53,0.509433962264151,"Raptors","Toronto",240,14,21,8,45,53,27,6,2,12,19,107,12
"team",21900660,"PHI",1610612755,32,84,0.381,18,46,0.391304347826087,0.722,14,38,0.368421052631579,"76ers","Philadelphia",240,13,18,8,37,45,25,8,6,13,23,95,-12
"team",21900661,"MIN",1610612750,41,86,0.477,15,44,0.340909090909091,0.542,26,42,0.619047619047619,"Timberwolves","Minnesota",240,13,24,10,33,43,27,7,3,18,25,110,-7
"team",21900661,"CHI",1610612741,39,84,0.464,9,30,0.3,0.811,30,54,0.555555555555556,"Bulls","Chicago",240,30,37,12,38,50,21,9,2,12,22,117,7
"team",21900662,"HOU",1610612745,42,89,0.472,13,29,0.448275862068966,0.857,29,60,0.483333333333333,"Rockets","Houston",240,24,28,18,35,53,26,10,7,17,16,121,16
"team",21900662,"DEN",1610612743,42,92,0.457,10,28,0.357142857142857,0.733,32,64,0.5,"Nuggets","Denver",240,11,15,13,27,40,25,12,6,15,21,105,-16
"team",21900663,"SAS",1610612759,45,89,0.506,11,27,0.407407407407407,0.8,34,62,0.548387096774194,"Spurs","San Antonio",240,20,25,9,35,44,17,7,4,11,23,121,4
"team",21900663,"NOP",1610612740,39,84,0.464,14,36,0.388888888888889,0.781,25,48,0.520833333333333,"Pelicans","New Orleans",240,25,32,8,33,41,26,6,3,14,21,117,-4
"team",21900664,"PHX",1610612756,30,84,0.357,4,20,0.2,0.885,26,64,0.40625,"Suns","Phoenix",240,23,26,9,35,44,13,7,3,13,20,87,-25
"team",21900664,"IND",1610612754,45,84,0.536,9,20,0.45,0.65,36,64,0.5625,"Pacers","Indiana",240,13,20,4,38,42,26,8,8,9,20,112,25
"team",21900665,"UTA",1610612762,50,93,0.538,17,40,0.425,0.522,33,53,0.622641509433962,"Jazz","Utah",240,12,23,15,41,56,31,5,3,9,19,129,33
"team",21900665,"GSW",1610612744,35,88,0.398,6,23,0.260869565217391,0.833,29,65,0.446153846153846,"Warriors","Golden State",240,20,24,11,26,37,20,5,5,8,23,96,-33
"team",21900666,"WAS",1610612764,47,85,0.553,16,36,0.444444444444444,0.778,31,49,0.63265306122449,"Wizards","Washington",240,14,18,7,34,41,28,3,3,10,18,124,12
"team",21900666,"CLE",1610612739,44,96,0.458,11,33,0.333333333333333,0.765,33,63,0.523809523809524,"Cavaliers","Cleveland",240,13,17,10,26,36,24,7,1,8,21,112,-12
"team",21900667,"LAL",1610612747,47,94,0.5,19,38,0.5,0.75,28,56,0.5,"Lakers","Los Angeles",240,15,20,11,41,52,28,9,6,15,15,128,15
"team",21900667,"BKN",1610612751,40,91,0.44,21,46,0.456521739130435,0.8,19,45,0.422222222222222,"Nets","Brooklyn",240,12,15,8,33,41,30,12,3,16,17,113,-15
"team",21900668,"POR",1610612757,46,91,0.505,21,39,0.538461538461538,0.8,25,52,0.480769230769231,"Trail Blazers","Portland",240,12,15,11,32,43,20,4,4,12,20,125,-8
"team",21900668,"DAL",1610612742,48,93,0.516,22,47,0.468085106382979,0.625,26,46,0.565217391304348,"Mavericks","Dallas",240,15,24,12,29,41,27,5,7,8,17,133,8
"team",21900669,"MIL",1610612749,44,87,0.506,10,36,0.277777777777778,0.75,34,51,0.666666666666667,"Bucks","Milwaukee",240,18,24,12,41,53,26,8,8,15,22,116,13
"team",21900669,"CHA",1610612766,32,86,0.372,14,39,0.358974358974359,0.833,18,47,0.382978723404255,"Hornets","Charlotte",240,25,30,8,31,39,24,6,3,13,22,103,-13
"team",21900670,"MEM",1610612763,43,79,0.544,11,22,0.5,0.903,32,57,0.56140350877193,"Grizzlies","Memphis",240,28,31,8,41,49,27,6,4,14,23,125,13
"team",21900670,"DET",1610612765,39,91,0.429,11,32,0.34375,0.742,28,59,0.474576271186441,"Pistons","Detroit",240,23,31,10,27,37,23,8,1,7,23,112,-13
"team",21900671,"ORL",1610612753,36,90,0.4,12,37,0.324324324324324,0.737,24,53,0.452830188679245,"Magic","Orlando",240,14,19,13,33,46,18,5,1,14,14,98,-11
"team",21900671,"BOS",1610612738,40,86,0.465,14,35,0.4,0.833,26,51,0.509803921568627,"Celtics","Boston",240,15,18,9,35,44,27,10,7,13,20,109,11
"team",21900672,"TOR",1610612761,41,81,0.506,17,35,0.485714285714286,0.826,24,46,0.521739130434783,"Raptors","Toronto",240,19,23,5,26,31,25,10,6,7,20,118,6
"team",21900672,"NYK",1610612752,42,85,0.494,13,36,0.361111111111111,0.714,29,49,0.591836734693878,"Knicks","New York",240,15,21,14,32,46,26,5,4,14,21,112,-6
"team",21900673,"MIA",1610612748,40,93,0.43,13,44,0.295454545454545,0.828,27,49,0.551020408163265,"Heat","Miami",240,24,29,9,36,45,25,4,4,9,19,117,-5
"team",21900673,"LAC",1610612746,43,94,0.457,16,35,0.457142857142857,0.87,27,59,0.457627118644068,"Clippers","LA",240,20,23,11,37,48,33,5,3,8,21,122,5
"team",21900674,"SAC",1610612758,35,81,0.432,10,32,0.3125,0.857,25,49,0.510204081632653,"Kings","Sacramento",240,18,21,7,35,42,24,8,8,13,20,98,17
"team",21900674,"CHI",1610612741,31,79,0.392,8,37,0.216216216216216,0.786,23,42,0.547619047619048,"Bulls","Chicago",240,11,14,8,35,43,23,6,4,19,21,81,-17
"team",21900675,"MIN",1610612750,48,98,0.49,11,32,0.34375,0.85,37,66,0.560606060606061,"Timberwolves","Minnesota",240,17,20,13,38,51,28,8,8,17,26,124,-7
"team",21900675,"HOU",1610612745,47,91,0.516,11,32,0.34375,0.839,36,59,0.610169491525424,"Rockets","Houston",240,26,31,5,30,35,24,11,9,11,18,131,7
"team",21900676,"NOP",1610612740,38,82,0.463,12,27,0.444444444444444,0.6,26,55,0.472727272727273,"Pelicans","New Orleans",240,18,30,12,33,45,24,8,7,17,17,106,-7
"team",21900676,"DEN",1610612743,40,106,0.377,13,41,0.317073170731707,1,27,65,0.415384615384615,"Nuggets","Denver",240,20,20,24,32,56,26,14,6,11,19,113,7
"team",21900677,"OKC",1610612760,50,86,0.581,14,25,0.56,0.765,36,61,0.590163934426229,"Thunder","Oklahoma City",240,26,34,6,39,45,28,6,5,14,20,140,29
"team",21900677,"ATL",1610612737,42,92,0.457,11,36,0.305555555555556,0.8,31,56,0.553571428571429,"Hawks","Atlanta",240,16,20,10,27,37,24,6,7,11,27,111,-29
"team",21900678,"SAS",1610612759,33,78,0.423,5,25,0.2,0.848,28,53,0.528301886792453,"Spurs","San Antonio",240,28,33,10,33,43,19,9,8,14,22,99,-4
"team",21900678,"PHX",1610612756,39,84,0.464,8,29,0.275862068965517,0.81,31,55,0.563636363636364,"Suns","Phoenix",240,17,21,10,32,42,25,6,4,13,27,103,4
"team",21900679,"IND",1610612754,50,87,0.575,17,28,0.607142857142857,0.923,33,59,0.559322033898305,"Pacers","Indiana",240,12,13,5,31,36,35,15,4,10,20,129,11
"team",21900679,"GSW",1610612744,40,82,0.488,19,39,0.487179487179487,0.826,21,43,0.488372093023256,"Warriors","Golden State",240,19,23,7,31,38,31,6,3,20,16,118,-11
"team",21900680,"UTA",1610612762,40,91,0.44,15,43,0.348837209302326,0.773,25,48,0.520833333333333,"Jazz","Utah",240,17,22,12,42,54,22,5,6,13,21,112,5
"team",21900680,"DAL",1610612742,42,97,0.433,16,41,0.390243902439024,0.538,26,56,0.464285714285714,"Mavericks","Dallas",240,7,13,10,34,44,19,6,3,9,24,107,-5
"team",21900681,"DET",1610612765,43,104,0.413,13,35,0.371428571428571,0.667,30,69,0.434782608695652,"Pistons","Detroit",265,12,18,14,38,52,20,5,3,8,25,111,-10
"team",21900681,"BKN",1610612751,42,94,0.447,15,42,0.357142857142857,0.88,27,52,0.519230769230769,"Nets","Brooklyn",265,22,25,11,44,55,19,3,5,10,17,121,10
"team",21900682,"CLE",1610612739,42,84,0.5,13,30,0.433333333333333,0.818,29,54,0.537037037037037,"Cavaliers","Cleveland",240,9,11,11,32,43,30,5,1,21,20,106,-12
"team",21900682,"CHI",1610612741,44,85,0.518,12,33,0.363636363636364,0.75,32,52,0.615384615384615,"Bulls","Chicago",240,18,24,7,29,36,24,15,2,9,16,118,12
"team",21900683,"OKC",1610612760,39,80,0.487,11,24,0.458333333333333,0.96,28,56,0.5,"Thunder","Oklahoma City",240,24,25,3,40,43,20,8,9,11,14,113,9
"team",21900683,"MIN",1610612750,40,90,0.444,12,43,0.27906976744186,0.667,28,47,0.595744680851064,"Timberwolves","Minnesota",240,12,18,7,34,41,33,9,4,13,21,104,-9
"team",21900684,"PHI",1610612755,41,78,0.526,13,37,0.351351351351351,0.684,28,41,0.682926829268293,"76ers","Philadelphia",240,13,19,8,33,41,19,12,3,21,18,108,17
"team",21900684,"LAL",1610612747,35,76,0.461,6,31,0.193548387096774,0.652,29,45,0.644444444444444,"Lakers","Los Angeles",240,15,23,6,29,35,23,12,1,21,18,91,-17
"team",21900685,"HOU",1610612745,40,88,0.455,11,33,0.333333333333333,0.704,29,55,0.527272727272727,"Rockets","Houston",240,19,27,15,29,44,19,6,7,16,21,110,-7
"team",21900685,"DEN",1610612743,44,93,0.473,11,28,0.392857142857143,0.9,33,65,0.507692307692308,"Nuggets","Denver",240,18,20,11,31,42,28,10,3,14,23,117,7
"team",21900686,"TOR",1610612761,41,99,0.414,16,50,0.32,0.8,25,49,0.510204081632653,"Raptors","Toronto",240,12,15,14,36,50,31,11,2,8,22,110,4
"team",21900686,"SAS",1610612759,34,82,0.415,16,37,0.432432432432432,0.917,18,45,0.4,"Spurs","San Antonio",240,22,24,7,41,48,27,5,8,16,15,106,-4
"team",21900687,"WAS",1610612764,42,88,0.477,11,33,0.333333333333333,0.905,31,55,0.563636363636364,"Wizards","Washington",240,38,42,8,26,34,20,5,7,11,26,133,-19
"team",21900687,"ATL",1610612737,54,93,0.581,15,35,0.428571428571429,0.853,39,58,0.672413793103448,"Hawks","Atlanta",240,29,34,12,36,48,30,7,3,14,35,152,19
"team",21900688,"NYK",1610612752,49,92,0.533,6,19,0.315789473684211,0.462,43,73,0.589041095890411,"Knicks","New York",240,6,13,14,34,48,19,7,8,13,23,110,13
"team",21900688,"BKN",1610612751,34,81,0.42,13,39,0.333333333333333,0.696,21,42,0.5,"Nets","Brooklyn",240,16,23,7,27,34,21,6,4,14,14,97,-13
"team",21900689,"ORL",1610612753,34,95,0.358,7,32,0.21875,0.688,27,63,0.428571428571429,"Magic","Orlando",240,22,32,16,28,44,27,9,7,6,23,97,-15
"team",21900689,"LAC",1610612746,37,79,0.468,13,30,0.433333333333333,0.862,24,49,0.489795918367347,"Clippers","LA",240,25,29,12,41,53,20,2,7,17,26,112,15
"team",21900690,"PHX",1610612756,35,92,0.38,11,29,0.379310344827586,0.8,24,63,0.380952380952381,"Suns","Phoenix",240,28,35,12,30,42,23,14,7,17,27,109,-5
"team",21900690,"MEM",1610612763,44,84,0.524,8,19,0.421052631578947,0.692,36,65,0.553846153846154,"Grizzlies","Memphis",240,18,26,8,38,46,25,10,8,25,27,114,5
"team",21900691,"NOP",1610612740,44,92,0.478,16,36,0.444444444444444,0.655,28,56,0.5,"Pelicans","New Orleans",240,19,29,18,36,54,31,7,5,18,21,123,15
"team",21900691,"BOS",1610612738,41,89,0.461,8,33,0.242424242424242,0.818,33,56,0.589285714285714,"Celtics","Boston",240,18,22,7,30,37,21,6,5,16,29,108,-15
"team",21900692,"POR",1610612757,49,90,0.544,20,35,0.571428571428571,0.84,29,55,0.527272727272727,"Trail Blazers","Portland",240,21,25,12,31,43,27,1,7,15,21,139,10
"team",21900692,"IND",1610612754,48,93,0.516,13,28,0.464285714285714,0.952,35,65,0.538461538461538,"Pacers","Indiana",240,20,21,6,25,31,31,5,2,6,19,129,-10
"team",21900693,"DET",1610612765,38,84,0.452,12,35,0.342857142857143,0.706,26,49,0.530612244897959,"Pistons","Detroit",240,12,17,9,28,37,18,8,7,17,20,100,-15
"team",21900693,"CLE",1610612739,48,96,0.5,9,24,0.375,0.769,39,72,0.541666666666667,"Cavaliers","Cleveland",240,10,13,11,34,45,25,9,6,13,21,115,15
"team",21900694,"ORL",1610612753,33,89,0.371,11,37,0.297297297297297,0.789,22,52,0.423076923076923,"Magic","Orlando",240,15,19,11,30,41,23,7,6,5,13,92,-21
"team",21900694,"MIA",1610612748,42,79,0.532,14,28,0.5,0.938,28,51,0.549019607843137,"Heat","Miami",240,15,16,3,38,41,31,2,9,10,18,113,21
"team",21900695,"SAS",1610612759,38,82,0.463,10,25,0.4,0.676,28,57,0.491228070175439,"Spurs","San Antonio",240,23,34,12,35,47,21,2,6,11,12,109,-1
"team",21900695,"CHI",1610612741,42,93,0.452,14,37,0.378378378378378,0.8,28,56,0.5,"Bulls","Chicago",240,12,15,14,36,50,28,8,2,9,23,110,1
"team",21900696,"SAC",1610612758,44,88,0.5,18,40,0.45,0.794,26,48,0.541666666666667,"Kings","Sacramento",265,27,34,9,35,44,27,6,8,15,27,133,4
"team",21900696,"MIN",1610612750,43,89,0.483,23,46,0.5,0.606,20,43,0.465116279069767,"Timberwolves","Minnesota",265,20,33,10,35,45,29,7,8,20,27,129,-4
"team",21900697,"OKC",1610612760,34,86,0.395,12,30,0.4,0.895,22,56,0.392857142857143,"Thunder","Oklahoma City",240,17,19,6,42,48,23,2,4,8,11,97,-10
"team",21900697,"DAL",1610612742,41,99,0.414,19,51,0.372549019607843,0.667,22,48,0.458333333333333,"Mavericks","Dallas",240,6,9,12,44,56,21,3,3,7,16,107,10
"team",21900698,"UTA",1610612762,43,85,0.506,12,42,0.285714285714286,0.731,31,43,0.720930232558139,"Jazz","Utah",240,19,26,2,36,38,24,7,3,17,33,117,-9
"team",21900698,"HOU",1610612745,38,81,0.469,15,40,0.375,0.714,23,41,0.560975609756098,"Rockets","Houston",240,35,49,6,34,40,14,11,4,15,25,126,9
"team",21900699,"NYK",1610612752,38,86,0.442,9,32,0.28125,0.636,29,54,0.537037037037037,"Knicks","New York",240,7,11,8,34,42,17,5,7,13,26,92,-5
"team",21900699,"CHA",1610612766,34,88,0.386,8,32,0.25,0.778,26,56,0.464285714285714,"Hornets","Charlotte",240,21,27,16,35,51,22,5,4,13,14,97,5
"team",21900702,"PHI",1610612755,42,82,0.512,11,32,0.34375,0.769,31,50,0.62,"76ers","Philadelphia",240,20,26,2,42,44,28,5,3,14,18,115,11
"team",21900702,"GSW",1610612744,37,87,0.425,15,40,0.375,0.714,22,47,0.468085106382979,"Warriors","Golden State",240,15,21,6,34,40,29,6,3,13,24,104,-11
"team",21900700,"NOP",1610612740,47,88,0.534,13,34,0.382352941176471,0.75,34,54,0.62962962962963,"Pelicans","New Orleans",240,18,24,7,34,41,29,9,11,16,16,125,14
"team",21900700,"CLE",1610612739,42,97,0.433,11,34,0.323529411764706,0.889,31,63,0.492063492063492,"Cavaliers","Cleveland",240,16,18,14,32,46,25,7,2,11,20,111,-14
"team",21900701,"MIA",1610612748,33,89,0.371,9,37,0.243243243243243,0.839,24,52,0.461538461538462,"Heat","Miami",240,26,31,11,34,45,15,11,2,10,21,101,-8
"team",21900701,"BOS",1610612738,39,83,0.47,13,36,0.361111111111111,0.75,26,47,0.553191489361702,"Celtics","Boston",240,18,24,11,37,48,24,5,8,14,22,109,8
"team",21900703,"TOR",1610612761,48,97,0.495,13,43,0.302325581395349,0.778,35,54,0.648148148148148,"Raptors","Toronto",240,21,27,10,42,52,26,10,6,12,26,130,16
"team",21900703,"ATL",1610612737,41,92,0.446,12,47,0.25531914893617,0.8,29,45,0.644444444444444,"Hawks","Atlanta",240,20,25,10,34,44,28,10,2,18,23,114,-16
"team",21900704,"MEM",1610612763,46,82,0.561,6,18,0.333333333333333,0.429,40,64,0.625,"Grizzlies","Memphis",240,6,14,6,35,41,32,12,11,16,18,104,8
"team",21900704,"DEN",1610612743,32,86,0.372,17,45,0.377777777777778,0.833,15,41,0.365853658536585,"Nuggets","Denver",240,15,18,13,31,44,23,9,4,19,16,96,-8
"team",21900705,"WAS",1610612764,44,94,0.468,14,32,0.4375,0.853,30,62,0.483870967741935,"Wizards","Washington",240,29,34,11,24,35,28,6,6,10,27,131,-20
"team",21900705,"MIL",1610612749,50,90,0.556,19,37,0.513513513513513,0.914,31,53,0.584905660377358,"Bucks","Milwaukee",240,32,35,11,35,46,31,3,3,14,26,151,20
"team",21900706,"PHX",1610612756,51,86,0.593,12,28,0.428571428571429,0.905,39,58,0.672413793103448,"Suns","Phoenix",240,19,21,8,31,39,34,10,4,11,25,133,29
"team",21900706,"DAL",1610612742,37,83,0.446,7,33,0.212121212121212,0.852,30,50,0.6,"Mavericks","Dallas",240,23,27,8,25,33,19,6,0,15,18,104,-29
"team",21900708,"IND",1610612754,46,89,0.517,7,27,0.259259259259259,0.727,39,62,0.629032258064516,"Pacers","Indiana",265,16,22,13,33,46,26,8,2,17,14,115,9
"team",21900708,"CHI",1610612741,45,85,0.529,6,33,0.181818181818182,0.667,39,52,0.75,"Bulls","Chicago",265,10,15,6,28,34,26,10,3,18,17,106,-9
"team",21900709,"DET",1610612765,42,83,0.506,10,26,0.384615384615385,0.75,32,57,0.56140350877193,"Pistons","Detroit",240,21,28,9,32,41,25,6,5,16,20,115,-10
"team",21900709,"BKN",1610612751,43,85,0.506,15,39,0.384615384615385,0.8,28,46,0.608695652173913,"Nets","Brooklyn",240,24,30,8,29,37,26,8,7,9,19,125,10
"team",21900710,"NYK",1610612752,39,91,0.429,9,28,0.321428571428571,0.655,30,63,0.476190476190476,"Knicks","New York",240,19,29,11,35,46,26,9,6,16,22,106,-21
"team",21900710,"MEM",1610612763,43,86,0.5,13,28,0.464285714285714,0.848,30,58,0.517241379310345,"Grizzlies","Memphis",240,28,33,7,37,44,25,7,3,11,22,127,21
"team",21900711,"UTA",1610612762,37,84,0.44,14,38,0.368421052631579,0.696,23,46,0.5,"Jazz","Utah",240,32,46,12,31,43,18,4,0,13,22,120,-7
"team",21900711,"SAS",1610612759,46,82,0.561,8,31,0.258064516129032,0.9,38,51,0.745098039215686,"Spurs","San Antonio",240,27,30,4,31,35,23,5,2,9,27,127,7
"team",21900712,"POR",1610612757,46,89,0.517,13,36,0.361111111111111,0.741,33,53,0.622641509433962,"Trail Blazers","Portland",240,20,27,10,40,50,24,8,8,18,20,125,13
"team",21900712,"HOU",1610612745,40,94,0.426,17,47,0.361702127659574,0.833,23,47,0.48936170212766,"Rockets","Houston",240,15,18,9,30,39,21,8,5,15,23,112,-13
"team",21900713,"SAC",1610612758,42,91,0.462,9,39,0.230769230769231,0.636,33,52,0.634615384615385,"Kings","Sacramento",240,7,11,11,28,39,22,6,2,13,22,100,-20
"team",21900713,"OKC",1610612760,44,88,0.5,15,34,0.441176470588235,0.85,29,54,0.537037037037037,"Thunder","Oklahoma City",240,17,20,10,35,45,32,9,5,13,17,120,20
"team",21900714,"TOR",1610612761,41,84,0.488,12,32,0.375,0.75,29,52,0.557692307692308,"Raptors","Toronto",240,21,28,9,28,37,23,13,3,13,20,115,6
"team",21900714,"CLE",1610612739,42,90,0.467,13,36,0.361111111111111,0.857,29,54,0.537037037037037,"Cavaliers","Cleveland",240,12,14,15,37,52,23,7,3,21,21,109,-6
"team",21900715,"WAS",1610612764,41,86,0.477,14,37,0.378378378378378,0.926,27,49,0.551020408163265,"Wizards","Washington",240,25,27,19,38,57,24,3,6,18,22,121,14
"team",21900715,"CHA",1610612766,43,99,0.434,9,30,0.3,0.632,34,69,0.492753623188406,"Hornets","Charlotte",240,12,19,16,22,38,32,9,4,7,24,107,-14
"team",21900716,"PHI",1610612755,38,82,0.463,9,31,0.290322580645161,0.711,29,51,0.568627450980392,"76ers","Philadelphia",240,32,45,8,34,42,22,11,2,12,21,117,-10
"team",21900716,"ATL",1610612737,42,87,0.483,11,35,0.314285714285714,0.865,31,52,0.596153846153846,"Hawks","Atlanta",240,32,37,10,38,48,29,5,4,16,29,127,10
"team",21900717,"GSW",1610612744,33,77,0.429,12,39,0.307692307692308,0.867,21,38,0.552631578947368,"Warriors","Golden State",240,26,30,3,27,30,24,11,6,16,19,104,-15
"team",21900717,"BOS",1610612738,42,88,0.477,15,35,0.428571428571429,0.909,27,53,0.509433962264151,"Celtics","Boston",240,20,22,14,37,51,27,12,4,22,24,119,15
"team",21900718,"UTA",1610612762,36,78,0.462,17,37,0.459459459459459,0.647,19,41,0.463414634146341,"Jazz","Utah",240,11,17,5,30,35,24,4,6,16,17,100,-6
"team",21900718,"DEN",1610612743,40,85,0.471,9,27,0.333333333333333,0.81,31,58,0.53448275862069,"Nuggets","Denver",240,17,21,8,35,43,25,7,5,9,16,106,6
"team",21900719,"SAC",1610612758,44,88,0.5,21,41,0.51219512195122,0.833,23,47,0.48936170212766,"Kings","Sacramento",240,15,18,11,36,47,27,11,8,10,21,124,21
"team",21900719,"LAC",1610612746,35,92,0.38,13,31,0.419354838709677,0.8,22,61,0.360655737704918,"Clippers","LA",240,20,25,11,28,39,26,6,6,15,20,103,-21
"team",21900720,"TOR",1610612761,44,85,0.518,9,27,0.333333333333333,0.727,35,58,0.603448275862069,"Raptors","Toronto",240,8,11,7,35,42,26,6,7,14,27,105,13
"team",21900720,"DET",1610612765,28,79,0.354,11,36,0.305555555555556,0.735,17,43,0.395348837209302,"Pistons","Detroit",240,25,34,13,32,45,18,5,6,15,12,92,-13
"team",21900721,"CHI",1610612741,42,86,0.488,12,34,0.352941176470588,0.846,30,52,0.576923076923077,"Bulls","Chicago",240,22,26,11,27,38,27,7,3,13,21,118,-15
"team",21900721,"BKN",1610612751,50,80,0.625,15,31,0.483870967741935,0.72,35,49,0.714285714285714,"Nets","Brooklyn",240,18,25,5,32,37,31,8,5,20,21,133,15
"team",21900722,"HOU",1610612745,45,98,0.459,21,45,0.466666666666667,0.85,24,53,0.452830188679245,"Rockets","Houston",240,17,20,7,30,37,25,11,5,6,20,128,7
"team",21900722,"DAL",1610612742,43,90,0.478,14,36,0.388888888888889,0.778,29,54,0.537037037037037,"Mavericks","Dallas",240,21,27,14,38,52,29,2,9,17,18,121,-7
"team",21900723,"NOP",1610612740,51,95,0.537,15,34,0.441176470588235,0.846,36,61,0.590163934426229,"Pelicans","New Orleans",240,22,26,16,41,57,30,8,4,19,22,139,28
"team",21900723,"MEM",1610612763,45,96,0.469,6,31,0.193548387096774,0.577,39,65,0.6,"Grizzlies","Memphis",240,15,26,11,23,34,17,10,8,11,21,111,-28
"team",21900724,"MIL",1610612749,43,95,0.453,12,40,0.3,0.654,31,55,0.563636363636364,"Bucks","Milwaukee",240,17,26,7,39,46,29,7,5,13,14,115,-12
"team",21900724,"DEN",1610612743,48,100,0.48,22,46,0.478260869565217,1,26,54,0.481481481481481,"Nuggets","Denver",240,9,9,7,43,50,29,8,10,12,19,127,12
"team",21900725,"PHX",1610612756,36,76,0.474,9,24,0.375,0.897,27,52,0.519230769230769,"Suns","Phoenix",240,26,29,11,29,40,20,6,6,19,25,107,-4
"team",21900725,"OKC",1610612760,42,97,0.433,7,31,0.225806451612903,0.909,35,66,0.53030303030303,"Thunder","Oklahoma City",240,20,22,15,26,41,26,13,4,12,24,111,4
"team",21900726,"POR",1610612757,49,97,0.505,13,36,0.361111111111111,0.762,36,61,0.590163934426229,"Trail Blazers","Portland",240,16,21,6,35,41,25,9,8,5,22,127,8
"team",21900726,"LAL",1610612747,45,96,0.469,11,32,0.34375,0.643,34,64,0.53125,"Lakers","Los Angeles",240,18,28,18,43,61,28,2,10,17,21,119,-8
"team",21900727,"MIN",1610612750,34,84,0.405,7,39,0.179487179487179,0.838,27,45,0.6,"Timberwolves","Minnesota",240,31,37,6,38,44,24,9,4,17,20,106,-12
"team",21900727,"LAC",1610612746,45,98,0.459,12,34,0.352941176470588,0.889,33,64,0.515625,"Clippers","LA",240,16,18,12,38,50,20,8,7,13,30,118,12
"team",21900728,"NYK",1610612752,34,82,0.415,7,26,0.269230769230769,0.739,27,56,0.482142857142857,"Knicks","New York",240,17,23,14,43,57,19,5,1,12,20,92,7
"team",21900728,"IND",1610612754,32,76,0.421,8,24,0.333333333333333,0.619,24,52,0.461538461538462,"Pacers","Indiana",240,13,21,4,30,34,21,4,1,11,20,85,-7
"team",21900729,"ORL",1610612753,33,83,0.398,9,33,0.272727272727273,0.824,24,50,0.48,"Magic","Orlando",240,14,17,7,32,39,21,5,5,9,19,89,-13
"team",21900729,"MIA",1610612748,33,77,0.429,15,33,0.454545454545455,0.808,18,44,0.409090909090909,"Heat","Miami",240,21,26,10,38,48,24,6,8,13,16,102,13
"team",21900730,"GSW",1610612744,48,90,0.533,18,35,0.514285714285714,0.895,30,55,0.545454545454545,"Warriors","Golden State",240,17,19,10,34,44,39,11,10,11,16,131,19
"team",21900730,"CLE",1610612739,41,95,0.432,16,44,0.363636363636364,1,25,51,0.490196078431373,"Cavaliers","Cleveland",240,14,14,13,33,46,26,8,3,15,15,112,-19
"team",21900731,"WAS",1610612764,44,100,0.44,9,32,0.28125,0.615,35,68,0.514705882352941,"Wizards","Washington",240,16,26,18,33,51,21,9,9,9,20,113,6
"team",21900731,"BKN",1610612751,39,94,0.415,16,47,0.340425531914894,0.619,23,47,0.48936170212766,"Nets","Brooklyn",240,13,21,12,41,53,25,5,7,15,22,107,-6
"team",21900732,"PHI",1610612755,31,84,0.369,7,33,0.212121212121212,0.839,24,51,0.470588235294118,"76ers","Philadelphia",240,26,31,13,34,47,15,6,3,14,27,95,-21
"team",21900732,"BOS",1610612738,38,80,0.475,8,30,0.266666666666667,0.78,30,50,0.6,"Celtics","Boston",240,32,41,9,33,42,15,9,2,10,20,116,21
"team",21900733,"DAL",1610612742,44,94,0.468,20,39,0.512820512820513,0.938,24,55,0.436363636363636,"Mavericks","Dallas",240,15,16,10,43,53,26,6,8,9,14,123,23
"team",21900733,"ATL",1610612737,37,91,0.407,10,33,0.303030303030303,0.762,27,58,0.46551724137931,"Hawks","Atlanta",240,16,21,10,40,50,19,6,4,11,15,100,-23
"team",21900734,"SAS",1610612759,45,87,0.517,10,28,0.357142857142857,0.667,35,59,0.593220338983051,"Spurs","San Antonio",240,14,21,7,37,44,27,13,2,10,14,114,24
"team",21900734,"CHA",1610612766,35,83,0.422,10,36,0.277777777777778,0.833,25,47,0.531914893617021,"Hornets","Charlotte",240,10,12,6,31,37,29,5,7,17,18,90,-24
"team",21900736,"SAC",1610612758,39,91,0.429,14,44,0.318181818181818,0.808,25,47,0.531914893617021,"Kings","Sacramento",240,21,26,13,31,44,21,5,4,16,24,113,-16
"team",21900736,"LAL",1610612747,44,86,0.512,19,43,0.441860465116279,0.815,25,43,0.581395348837209,"Lakers","Los Angeles",240,22,27,11,35,46,33,10,5,14,22,129,16
"team",21900735,"UTA",1610612762,40,94,0.426,18,41,0.439024390243902,1,22,53,0.415094339622642,"Jazz","Utah",240,9,9,11,26,37,19,6,4,9,17,107,-17
"team",21900735,"POR",1610612757,47,92,0.511,15,29,0.517241379310345,0.833,32,63,0.507936507936508,"Trail Blazers","Portland",240,15,18,14,37,51,20,4,5,12,19,124,17
"team",21900737,"DET",1610612765,48,94,0.511,14,31,0.451612903225806,0.75,34,63,0.53968253968254,"Pistons","Detroit",265,18,24,11,32,43,33,4,2,11,22,128,5
"team",21900737,"DEN",1610612743,48,96,0.5,10,32,0.3125,0.773,38,64,0.59375,"Nuggets","Denver",265,17,22,14,33,47,30,7,7,9,19,123,-5
"team",21900738,"NOP",1610612740,42,94,0.447,10,33,0.303030303030303,0.75,32,61,0.524590163934426,"Pelicans","New Orleans",240,15,20,16,47,63,21,6,6,21,16,109,-8
"team",21900738,"HOU",1610612745,41,105,0.39,16,51,0.313725490196078,0.864,25,54,0.462962962962963,"Rockets","Houston",240,19,22,11,32,43,22,14,3,7,18,117,8
"team",21900739,"PHX",1610612756,41,105,0.39,6,23,0.260869565217391,0.87,35,82,0.426829268292683,"Suns","Phoenix",240,20,23,16,34,50,20,8,3,10,24,108,-21
"team",21900739,"MIL",1610612749,48,97,0.495,15,38,0.394736842105263,0.667,33,59,0.559322033898305,"Bucks","Milwaukee",240,18,27,16,44,60,30,4,13,16,25,129,21
"team",21900740,"TOR",1610612761,47,84,0.56,16,34,0.470588235294118,0.826,31,50,0.62,"Raptors","Toronto",240,19,23,12,34,46,28,6,5,15,18,129,27
"team",21900740,"CHI",1610612741,35,90,0.389,15,48,0.3125,0.654,20,42,0.476190476190476,"Bulls","Chicago",240,17,26,17,24,41,25,10,0,16,21,102,-27
